Gegeneophis_carnosus	D
Gegeneophis_seshachari	D
Gegeneophis_krishni	D
Gegeneophis_ramaswamii	D
Gegeneophis_danieli	D
Gegeneophis_goaensis	D
Gegeneophis_mhadeiensis	D
Gegeneophis_madhavai	D
Indotyphlus_battersbyi	D
Indotyphlus_maharashtraensis	D
Grandisonia_alternans	D
Grandisonia_larvata	S
Grandisonia_sechellensis	S
Hypogeophis_brevis	S
Hypogeophis_rostratus	D
Praslinia_cooperi	S
Dermophis_oaxacae	V
Dermophis_mexicanus	V
Dermophis_parviceps	V
Gymnopis_multiplicata	V
Schistometopum_thomense	V
Schistometopum_gregorii	V
Geotrypetes_seraphini	V
Siphonops_annulatus	D
Siphonops_paulensis	D
Siphonops_hardyi	D
Luetkenotyphlus_brasiliensis	D
Microcaecilia_unicolor	D
Microcaecilia_dermatophaga	D
Caecilia_tentaculata	D
Caecilia_gracilis	-
Caecilia_volcani	D
Oscaecilia_ochrocephala	D
Typhlonectes_natans	V
Typhlonectes_compressicauda	V
Chthonerpeton_indistinctum	V
Boulengerula_niedeni	D
Boulengerula_taitana	D
Boulengerula_uluguruensis	D
Boulengerula_changamwensis	D
Boulengerula_fischeri	D
Boulengerula_boulengeri	D
Herpele_squalostoma	D
Chikila_fulleri	D
Crotaphatrema_tchabalmbaboensis	D
Crotaphatrema_lamottei	D
Scolecomorphus_vittatus	V
Scolecomorphus_uluguruensis	V
Ichthyophis_larutensis	S
Ichthyophis_biangularis	S
Ichthyophis_bannanicus	S
Ichthyophis_asplenius	S
Ichthyophis_longicephalus	S
Ichthyophis_tricolor	S
Ichthyophis_orthoplicatus	S
Ichthyophis_glutinosus	S
Uraeotyphlus_gansi	S
Uraeotyphlus_narayani	S
Ichthyophis_bombayensis	S
Rhinatrema_bivittatum	S
Rhinatrema_shiv	S
Rhinatrema_nigrum	S
Epicrionops_marmoratus	S
