Ansonia_thinthinae	A
Ansonia_kraensis	A
Ansonia_inthanon	A
Ansonia_siamensis	A
Ansonia_endauensis	A
Ansonia_latirostra	A
Ansonia_tiomanica	A
Ansonia_malayana	A
Ansonia_penangensis	A
Ansonia_hanitschi	A
Ansonia_platysoma	A
Ansonia_minuta	A
Ansonia_spinulifer	A
Ansonia_latidisca	A
Ansonia_leptopus	A
Ansonia_torrentis	A
Ansonia_longidigita	A
Ansonia_albomaculata	A
Ansonia_fuliginea	A
Ansonia_guibei	A
Ansonia_mcgregori	A
Ansonia_muelleri	A
Pelophryne_signata	A
Pelophryne_brevipes	A
Pelophryne_misera	A
Ghatophryne_ornata	A
Barbarophryne_brongersmai	A
Ingerophrynus_parvus	A
Ingerophrynus_biporcatus	A
Ingerophrynus_divergens	A
Ingerophrynus_philippinicus	A
Ingerophrynus_galeatus	A
Ingerophrynus_macrotis	A
Ingerophrynus_celebensis	A
Phrynoidis_juxtasper	A
Phrynoidis_asper	A
Rentapia_everetti	A
Rentapia_hosii	A
Bufo_bankorensis	A
Bufo_gargarizans	A
Bufo_tuberculatus	A
Bufo_stejnegeri	A
Bufo_torrenticola	A
Bufo_japonicus	A
Bufo_cryptotympanicus	A
Bufo_aspinius	A
Bufo_tuberospinius	A
Bufo_bufo	A
Bufo_spinosus	A
Bufo_verrucosissimus	A
Bufo_eichwaldi	A
Strauchbufo_raddei	A
Sabahphrynus_maculatus	A
Werneria_mertensiana	A
Werneria_tandyi	A
Werneria_bambutensis	A
Wolterstorffina_parvipalmata	A
Didynamipus_sjostedti	D
Nimbaphrynoides_occidentalis	V
Nectophryne_batesii	A
Nectophryne_afra	A
Leptophryne_borbonica	A
Epidalea_calamita	A
Duttaphrynus_melanostictus	A
Duttaphrynus_parietalis	A
Duttaphrynus_brevirostris	A
Duttaphrynus_atukoralei	A
Duttaphrynus_scaber	A
Duttaphrynus_himalayanus	A
Duttaphrynus_crocus	A
Duttaphrynus_stuarti	A
Duttaphrynus_hololius	A
Duttaphrynus_stomaticus	A
Duttaphrynus_dhufarensis	A
Xanthophryne_koynayensis	A
Adenomus_kelaartii	A
Pedostibes_tuberculosus	A
Nectophrynoides_tornieri	V
Nectophrynoides_minutus	V
Nectophrynoides_viviparus	V
Churamiti_maridadi	A
Schismaderma_carens	A
Bufotes_viridis	A
Bufotes_variabilis	A
Bufotes_balearicus	A
Bufotes_pewzowi	A
Bufotes_oblongus	A
Bufotes_boulengeri	A
Bufotes_siculus	A
Sclerophrys_kisoloensis	A
Sclerophrys_gracilipes	A
Sclerophrys_camerunensis	A
Sclerophrys_latifrons	A
Sclerophrys_xeros	A
Sclerophrys_garmani	A
Sclerophrys_gutturalis	A
Sclerophrys_regularis	A
Sclerophrys_maculata	A
Sclerophrys_tuberosa	A
Sclerophrys_pardalis	A
Sclerophrys_pantherina	A
Sclerophrys_poweri	A
Sclerophrys_brauni	A
Sclerophrys_lemairii	A
Sclerophrys_channingi	A
Sclerophrys_capensis	A
Sclerophrys_steindachneri	A
Sclerophrys_mauritanica	A
Vandijkophrynus_robinsoni	A
Vandijkophrynus_gariepensis	A
Vandijkophrynus_angusticeps	A
Vandijkophrynus_inyangae	A
Vandijkophrynus_amatolicus	A
Mertensophryne_loveridgei	A
Mertensophryne_anotis	A
Mertensophryne_lindneri	A
Mertensophryne_micranotis	A
Mertensophryne_taitana	A
Mertensophryne_uzunguensis	A
Poyntonophrynus_dombensis	A
Poyntonophrynus_damaranus	A
Poyntonophrynus_fenoulheti	A
Poyntonophrynus_hoeschi	A
Capensibufo_tradouwi	A
Capensibufo_rosei	A
Incilius_leucomyos	A
Incilius_campbelli	A
Incilius_macrocristatus	A
Incilius_tutelarius	A
Incilius_cristatus	A
Incilius_cavifrons	A
Incilius_spiculatus	A
Incilius_valliceps	A
Incilius_nebulifer	A
Incilius_aucoinae	A
Incilius_melanochlorus	A
Incilius_luetkenii	A
Incilius_mazatlanensis	A
Incilius_signifer	A
Incilius_cycladen	A
Incilius_porteri	A
Incilius_ibarrai	A
Incilius_coccifer	A
Incilius_pisinnus	A
Incilius_karenlipsae	A
Incilius_coniferus	A
Incilius_chompipe	A
Incilius_fastidiosus	A
Incilius_perplexus	A
Incilius_canaliferus	A
Incilius_marmoreus	A
Incilius_occidentalis	A
Incilius_alvarius	A
Incilius_tacanensis	A
Incilius_bocourti	A
Anaxyrus_baxteri	A
Anaxyrus_hemiophrys	A
Anaxyrus_houstonensis	A
Anaxyrus_woodhousii	A
Anaxyrus_americanus	A
Anaxyrus_fowleri	A
Anaxyrus_terrestris	A
Anaxyrus_microscaphus	A
Anaxyrus_californicus	A
Anaxyrus_speciosus	A
Anaxyrus_debilis	A
Anaxyrus_retiformis	A
Anaxyrus_cognatus	A
Anaxyrus_quercicus	A
Anaxyrus_punctatus	A
Anaxyrus_canorus	A
Anaxyrus_exsul	A
Anaxyrus_nelsoni	A
Anaxyrus_boreas	A
Rhinella_cerradensis	A
Rhinella_diptycha	A
Rhinella_jimi	A
Rhinella_marina	A
Rhinella_poeppigii	A
Rhinella_veredas	A
Rhinella_icterica	A
Rhinella_achavali	A
Rhinella_rubescens	A
Rhinella_arenarum	A
Rhinella_henseli	A
Rhinella_ornata	A
Rhinella_abei	A
Rhinella_crucifer	A
Rhinella_inopina	A
Rhinella_major	A
Rhinella_mirandaribeiroi	A
Rhinella_granulosa	A
Rhinella_centralis	A
Rhinella_humboldti	A
Rhinella_merianae	A
Rhinella_martyi	A
Rhinella_dapsilis	A
Rhinella_lescurei	A
Rhinella_hoogmoedi	A
Rhinella_margaritifera	A
Rhinella_castaneotica	A
Rhinella_ocellata	A
Rhinella_yunga	A
Rhinella_macrorhina	-
Rhinella_rostrata	-
Rhinella_festae	-
Rhinella_chavin	A
Rhinella_yanachaga	A
Rhinella_manu	D
Rhinella_nesiotes	-
Rhinella_veraguensis	A
Rhinella_amboroensis	A
Rhinella_arequipensis	A
Rhinella_spinulosa	A
Rhinella_vellardi	A
Rhinella_limensis	A
Rhinella_arunco	A
Rhinella_atacamensis	A
Peltophryne_peltocephala	A
Peltophryne_florentinoi	A
Peltophryne_fustiger	A
Peltophryne_empusa	A
Peltophryne_taladai	A
Peltophryne_cataulaciceps	A
Peltophryne_longinasus	A
Peltophryne_gundlachi	A
Peltophryne_guentheri	A
Peltophryne_lemur	A
Rhaebo_glaberrimus	A
Rhaebo_guttatus	A
Rhaebo_haematiticus	A
Rhaebo_nasicus	A
Nannophryne_cophotis	A
Nannophryne_variegata	A
Dendrophryniscus_krausae	A
Dendrophryniscus_berthalutzae	A
Dendrophryniscus_leucomystax	A
Dendrophryniscus_brevipollicatus	A
Dendrophryniscus_oreites	A
Dendrophryniscus_carvalhoi	A
Dendrophryniscus_proboscideus	A
Amazophrynella_minuta	S
Amazophrynella_bokermanni	S
Atelopus_onorei	A
Atelopus_bomolochos	A
Atelopus_nanay	A
Atelopus_exiguus	A
Atelopus_halihelos	A
Atelopus_podocarpus	A
Atelopus_ignescens	A
Atelopus_longirostris	A
Atelopus_peruensis	A
Atelopus_varius	A
Atelopus_senex	A
Atelopus_limosus	A
Atelopus_zeteki	A
Atelopus_chiriquiensis	A
Atelopus_spurrelli	A
Atelopus_flavescens	A
Atelopus_franciscus	A
Atelopus_barbotini	A
Atelopus_hoogmoedi	A
Atelopus_spumarius	A
Atelopus_seminiferus	A
Atelopus_pulcher	A
Atelopus_oxapampae	A
Atelopus_tricolor	A
Osornophryne_sumacoensis	D
Osornophryne_occidentalis	D
Osornophryne_simpsoni	D
Osornophryne_guacamayo	D
Osornophryne_cofanorum	D
Osornophryne_bufoniformis	D
Osornophryne_angel	D
Osornophryne_antisana	D
Osornophryne_percrassa	D
Osornophryne_puruanta	D
Oreophrynella_nigra	D
Oreophrynella_quelchii	D
Oreophrynella_vasquezi	D
Oreophrynella_seegobini	D
Oreophrynella_macconnelli	D
Frostius_erythrophthalmus	A
Melanophryniscus_klappenbachi	A
Melanophryniscus_stelzneri	A
Melanophryniscus_rubriventris	A
Melanophryniscus_fulvoguttatus	A
Melanophryniscus_devincenzii	A
Melanophryniscus_pachyrhynus	A
Melanophryniscus_setiba	A
Proceratophrys_renalis	A
Proceratophrys_boiei	A
Proceratophrys_laticeps	A
Proceratophrys_cururu	A
Proceratophrys_concavitympanum	A
Proceratophrys_moratoi	A
Proceratophrys_goyana	A
Proceratophrys_appendiculata	A
Proceratophrys_melanopogon	A
Proceratophrys_minuta	A
Proceratophrys_redacta	A
Proceratophrys_cristiceps	A
Proceratophrys_schirchi	A
Proceratophrys_bigibbosa	A
Proceratophrys_avelinoi	A
Odontophrynus_occidentalis	A
Odontophrynus_americanus	A
Odontophrynus_cultripes	A
Odontophrynus_carvalhoi	A
Macrogenioglottus_alipioi	A
Centrolene_sabini	S
Centrolene_lynchi	S
Centrolene_hesperia	S
Centrolene_venezuelensis	S
Centrolene_muelleri	S
Centrolene_huilensis	S
Centrolene_altitudinalis	S
Centrolene_notosticta	S
Centrolene_ballux	S
Centrolene_buckleyi	S
Centrolene_heloderma	S
Centrolene_hybrida	S
Centrolene_pipilata	S
Centrolene_bacata	S
Centrolene_condor	S
Centrolene_antioquiensis	S
Centrolene_peristicta	S
Centrolene_savagei	S
Centrolene_daidalea	S
Centrolene_geckoidea	S
Nymphargus_siren	S
Nymphargus_vicenteruedai	S
Nymphargus_megacheirus	S
Nymphargus_anomalus	S
Nymphargus_rosada	S
Nymphargus_lasgralarias	S
Nymphargus_griffithsi	S
Nymphargus_cochranae	S
Nymphargus_wileyi	S
Nymphargus_mariae	S
Nymphargus_chancas	S
Nymphargus_grandisonae	S
Nymphargus_ocellatus	S
Nymphargus_pluvialis	S
Nymphargus_posadae	S
Nymphargus_bejaranoi	S
Nymphargus_mixomaculatus	S
Rulyrana_saxiscandens	S
Rulyrana_flavopunctata	S
Rulyrana_spiculata	S
Rulyrana_susatamai	S
Rulyrana_adiazeta	S
Sachatamia_orejuela	S
Sachatamia_ilex	S
Sachatamia_punctulata	S
Sachatamia_albomaculata	S
Espadarana_durrellorum	S
Espadarana_audax	S
Espadarana_prosoblepon	S
Espadarana_callistomma	S
Espadarana_andina	S
Chimerella_mariaelenae	S
Cochranella_mache	S
Cochranella_euknemos	S
Cochranella_granulosa	S
Cochranella_resplendens	S
Cochranella_litoralis	S
Cochranella_nola	S
Vitreorana_helenae	S
Vitreorana_ritae	S
Vitreorana_gorzulae	S
Vitreorana_eurygnatha	S
Vitreorana_antisthenesi	S
Vitreorana_castroviejoi	S
Vitreorana_uranoscopa	S
Teratohyla_midas	S
Teratohyla_adenocheira	S
Teratohyla_spinosa	S
Teratohyla_pulverata	S
Teratohyla_amelie	S
Ikakogi_tayrona	S
Hyalinobatrachium_orocostale	S
Hyalinobatrachium_fragile	S
Hyalinobatrachium_orientale	S
Hyalinobatrachium_pallidum	S
Hyalinobatrachium_ibama	S
Hyalinobatrachium_duranti	S
Hyalinobatrachium_carlesvilai	S
Hyalinobatrachium_kawense	S
Hyalinobatrachium_fleischmanni	S
Hyalinobatrachium_tatayoi	S
Hyalinobatrachium_mondolfii	S
Hyalinobatrachium_munozorum	S
Hyalinobatrachium_iaspidiense	S
Hyalinobatrachium_tricolor	S
Hyalinobatrachium_cappellei	S
Hyalinobatrachium_taylori	S
Hyalinobatrachium_colymbiphyllum	S
Hyalinobatrachium_chirripoi	S
Hyalinobatrachium_pellucidum	S
Hyalinobatrachium_bergeri	S
Hyalinobatrachium_talamancae	S
Hyalinobatrachium_valerioi	S
Hyalinobatrachium_aureoguttatum	S
Celsiella_vozmedianoi	S
Celsiella_revocata	S
Allophryne_ruthveni	A
Allophryne_resplendens	A
Allophryne_relicta	A
Leptodactylus_didymus	S
Leptodactylus_notoaktites	S
Leptodactylus_mystaceus	S
Leptodactylus_spixi	-
Leptodactylus_elenae	S
Leptodactylus_gracilis	S
Leptodactylus_plaumanni	S
Leptodactylus_bufonius	S
Leptodactylus_fragilis	S
Leptodactylus_fuscus	S
Leptodactylus_longirostris	S
Leptodactylus_poecilochilus	-
Leptodactylus_albilabris	S
Leptodactylus_mystacinus	S
Leptodactylus_rhodonotus	-
Leptodactylus_labyrinthicus	S
Leptodactylus_fallax	S
Leptodactylus_myersi	S
Leptodactylus_pentadactylus	S
Leptodactylus_knudseni	S
Leptodactylus_stenodema	S
Leptodactylus_vastus	S
Leptodactylus_griseigularis	S
Leptodactylus_discodactylus	S
Leptodactylus_podicipinus	S
Leptodactylus_diedrus	S
Leptodactylus_wagneri	S
Leptodactylus_validus	S
Leptodactylus_leptodactyloides	S
Leptodactylus_melanonotus	S
Leptodactylus_latrans	S
Leptodactylus_insularum	-
Leptodactylus_bolivianus	S
Leptodactylus_chaquensis	S
Leptodactylus_silvanimbus	S
Leptodactylus_riveroi	S
Leptodactylus_rhodomystax	S
Hydrolaetare_caparu	S
Leptodactylus_syphax	S
Adenomera_araucaria	-
Adenomera_engelsi	T
Adenomera_thomei	T
Adenomera_diptyx	S
Adenomera_hylaedactyla	T
Adenomera_martinezi	-
Adenomera_andreae	T
Adenomera_lutzi	T
Adenomera_heyeri	T
Lithodytes_lineatus	S
Paratelmatobius_poecilogaster	S
Paratelmatobius_gaigeae	A
Paratelmatobius_cardosoi	A
Scythrophrys_sawayae	A
Crossodactylodes_bokermanni	A
Crossodactylodes_izecksohni	A
Paratelmatobius_mantiqueira	A
Rupirana_cardosoi	A
Physalaemus_gracilis	S
Physalaemus_barrioi	S
Physalaemus_biligonigerus	S
Physalaemus_riograndensis	S
Physalaemus_olfersii	S
Physalaemus_ephippifer	S
Physalaemus_cuvieri	S
Physalaemus_centralis	S
Physalaemus_albonotatus	S
Physalaemus_henselii	S
Physalaemus_signifer	S
Physalaemus_crombiei	S
Physalaemus_atlanticus	S
Physalaemus_spiniger	S
Physalaemus_nattereri	S
Engystomops_randi	S
Engystomops_montubio	S
Engystomops_guayaco	S
Engystomops_coloradorum	S
Engystomops_puyango	S
Engystomops_pustulatus	S
Engystomops_petersi	S
Engystomops_freibergi	S
Engystomops_pustulosus	S
Edalorhina_perezi	S
Pleurodema_cordobae	A
Pleurodema_kriegi	A
Pleurodema_bibroni	A
Pleurodema_bufoninum	A
Pleurodema_thaul	A
Pleurodema_marmoratum	A
Pleurodema_nebulosum	S
Pleurodema_guayapae	S
Pleurodema_cinereum	S
Pleurodema_borellii	S
Pleurodema_tucumanum	A
Pleurodema_diplolister	S
Pleurodema_alium	S
Pleurodema_brachyops	S
Pseudopaludicola_falcipes	A
Pseudopaludicola_mystacalis	A
Dryophytes_euphorbiaceus	A
Dryophytes_plicatus	A
Dryophytes_eximius	A
Dryophytes_walkeri	A
Dryophytes_wrightorum	A
Dryophytes_arenicolor	A
Dryophytes_japonicus	A
Dryophytes_chrysoscelis	A
Dryophytes_avivoca	A
Dryophytes_versicolor	A
Dryophytes_femoralis	A
Dryophytes_andersonii	A
Dryophytes_cinereus	A
Dryophytes_gratiosus	A
Dryophytes_squirellus	A
Hyla_intermedia	A
Hyla_molleri	A
Hyla_sarda	A
Hyla_arborea	A
Hyla_savignyi	A
Hyla_felixarabica	A
Hyla_orientalis	A
Hyla_meridionalis	A
Hyla_tsinlingensis	A
Hyla_annectans	A
Hyla_chinensis	A
Smilisca_puma	A
Smilisca_phaeota	A
Smilisca_cyanosticta	A
Smilisca_fodiens	A
Smilisca_sordida	A
Smilisca_sila	A
Smilisca_baudinii	A
Triprion_petasatus	A
Triprion_spinosus	S
Triprion_spatulatus	A
Isthmohyla_rivularis	A
Isthmohyla_tica	A
Isthmohyla_pseudopuma	A
Isthmohyla_zeteki	S
Tlalocohyla_smithii	A
Tlalocohyla_picta	A
Tlalocohyla_loquax	A
Tlalocohyla_godmani	A
Charadrahyla_taeniopus	A
Charadrahyla_nephila	A
Megastomatohyla_mixe	A
Ptychohyla_leonhardschultzei	A
Ptychohyla_zophodes	A
Ptychohyla_euthysanota	A
Ptychohyla_hypomykter	A
Ptychohyla_dendrophasma	A
Atlantihyla_spinipollex	A
Ptychohyla_salvadorensis	A
Duellmanohyla_uranochroa	A
Duellmanohyla_rufioculis	A
Duellmanohyla_soralia	A
Bromeliohyla_bromeliacia	A
Ecnomiohyla_miliaria	A
Ecnomiohyla_minera	A
Ecnomiohyla_rabborum	A
Rheohyla_miotympanum	A
Sarcohyla_pentheter	A
Sarcohyla_labeculata	A
Sarcohyla_bistincta	A
Sarcohyla_ameibothalame	A
Sarcohyla_arborescandens	A
Sarcohyla_cyclada	A
Sarcohyla_siopela	A
Plectrohyla_matudai	A
Plectrohyla_guatemalensis	A
Plectrohyla_glandulosa	A
Plectrohyla_chrysopleura	A
Exerodonta_sumichrasti	A
Exerodonta_melanomma	A
Exerodonta_perkinsi	A
Exerodonta_abdivita	A
Exerodonta_chimalapa	A
Exerodonta_smaragdina	A
Exerodonta_xera	A
Pseudacris_maculata	A
Pseudacris_clarkii	A
Pseudacris_triseriata	A
Pseudacris_feriarum	A
Pseudacris_nigrita	A
Pseudacris_kalmi	A
Pseudacris_fouquettei	A
Pseudacris_brimleyi	A
Pseudacris_brachyphona	A
Pseudacris_streckeri	A
Pseudacris_illinoensis	A
Pseudacris_ornata	A
Pseudacris_ocularis	A
Pseudacris_crucifer	A
Pseudacris_regilla	A
Pseudacris_cadaverina	A
Acris_crepitans	A
Acris_blanchardi	A
Acris_gryllus	A
Osteocephalus_verruciger	A
Osteocephalus_cannatellai	A
Osteocephalus_buckleyi	A
Osteocephalus_helenae	A
Osteocephalus_cabrerai	A
Osteocephalus_festae	A
Osteocephalus_carri	A
Osteocephalus_mutabor	A
Osteocephalus_mimeticus	A
Osteocephalus_deridens	A
Osteocephalus_fuscifacies	A
Osteocephalus_leoniae	A
Osteocephalus_planiceps	A
Osteocephalus_castaneicola	A
Osteocephalus_yasuni	A
Osteocephalus_leprieurii	A
Osteocephalus_subtilis	A
Osteocephalus_heyeri	A
Osteocephalus_alboguttatus	A
Osteocephalus_oophagus	A
Osteocephalus_taurinus	A
Tepuihyla_rodriguezi	A
Tepuihyla_edelcae	A
Tepuihyla_aecii	A
Tepuihyla_exophthalma	A
Osteopilus_marianae	A
Osteopilus_wilderi	A
Osteopilus_crucialis	A
Osteopilus_dominicensis	A
Osteopilus_pulchrilineatus	A
Osteopilus_septentrionalis	A
Osteopilus_vastus	A
Phyllodytes_luteolus	A
Itapotihyla_langsdorffii	A
Trachycephalus_imitatrix	A
Trachycephalus_mesophaeus	A
Trachycephalus_nigromaculatus	A
Trachycephalus_hadroceps	A
Trachycephalus_typhonius	A
Trachycephalus_resinifictrix	A
Trachycephalus_coriaceus	S
Trachycephalus_jordani	A
Corythomantis_greeningi	A
Argenteohyla_siemersi	A
Nyctimantis_rugiceps	A
Aparasphenodon_brunoi	A
Phytotriades_auratus	A
Dendropsophus_rubicundulus	A
Dendropsophus_sanborni	A
Dendropsophus_tritaeniatus	-
Dendropsophus_minusculus	A
Dendropsophus_juliani	-
Dendropsophus_berthalutzae	S
Dendropsophus_bipunctatus	A
Dendropsophus_nanus	A
Dendropsophus_walfordi	A
Dendropsophus_riveroi	A
Dendropsophus_reichlei	A
Dendropsophus_gaucheri	-
Dendropsophus_branneri	S
Dendropsophus_microcephalus	S
Dendropsophus_phlebodes	A
Dendropsophus_rhodopeplus	A
Dendropsophus_sartori	-
Dendropsophus_robertmertensi	-
Dendropsophus_leali	A
Dendropsophus_anceps	A
Dendropsophus_schubarti	S
Dendropsophus_minutus	A
Dendropsophus_manonegra	-
Dendropsophus_bifurcus	S
Dendropsophus_sarayacuensis	S
Dendropsophus_ebraccatus	S
Dendropsophus_triangulum	S
Dendropsophus_leucophyllatus	S
Dendropsophus_elegans	A
Dendropsophus_salli	S
Dendropsophus_timbeba	A
Dendropsophus_miyatai	A
Dendropsophus_parviceps	A
Dendropsophus_koechlini	A
Dendropsophus_frosti	S
Dendropsophus_brevifrons	S
Dendropsophus_giesleri	S
Dendropsophus_meridensis	A
Dendropsophus_luddeckei	A
Dendropsophus_molitor	A
Dendropsophus_carnifex	A
Dendropsophus_marmoratus	A
Dendropsophus_melanargyreus	A
Dendropsophus_seniculus	A
Dendropsophus_aperomeus	A
Xenohyla_truncata	A
Pseudis_fusca	A
Pseudis_tocantins	S
Pseudis_paradoxa	S
Pseudis_bolbodactyla	A
Pseudis_cardosoi	A
Pseudis_minuta	S
Lysapsus_limellum	S
Lysapsus_bolivianus	S
Lysapsus_caraya	S
Lysapsus_laevis	S
Scarthyla_goinorum	A
Scinax_chiquitanus	A
Scinax_funereus	A
Scinax_oreites	A
Scinax_ictericus	A
Scinax_similis	A
Scinax_duartei	A
Scinax_hayii	A
Scinax_ruber	A
Scinax_x-signatus	A
Scinax_nasicus	A
Scinax_fuscovarius	A
Scinax_fuscomarginatus	A
Scinax_boesemani	A
Scinax_staufferi	A
Scinax_cruentomma	A
Scinax_elaeochroa	A
Scinax_squalirostris	A
Scinax_crospedospilus	A
Scinax_garbei	A
Scinax_proboscideus	A
Scinax_jolyi	A
Scinax_rostratus	A
Scinax_sugillatus	A
Scinax_boulengeri	A
Scinax_nebulosus	A
Scinax_quinquefasciatus	A
Scinax_acuminatus	A
Julianus_uruguayus	A
Ololygon_obtriangulata	A
Ololygon_berthae	A
Ololygon_catharinae	A
Ololygon_peixotoi	A
Ololygon_faivovichi	A
Ololygon_perpusilla	A
Sphaenorhynchus_dorisae	A
Sphaenorhynchus_lacteus	A
Sphaenorhynchus_platycephalus	A
Boana_pulchella	A
Boana_cordobae	A
Boana_prasina	A
Boana_caingua	A
Boana_marginata	A
Boana_bischoffi	A
Boana_guentheri	A
Boana_marianitae	A
Boana_balzani	A
Boana_callipleura	A
Boana_riojana	A
Boana_curupi	A
Boana_latistriata	A
Boana_polytaenia	A
Boana_leptolineata	A
Boana_semiguttata	A
Boana_caipora	A
Boana_joaquini	A
Boana_aguilari	A
Boana_palaestes	A
Boana_gladiator	A
Boana_melanopleura	A
Boana_ericae	A
Boana_pardalis	A
Boana_lundii	A
Boana_faber	A
Boana_crepitans	A
Boana_rosenbergi	A
Boana_albomarginata	A
Boana_pellucens	A
Boana_rufitela	A
Boana_fasciata	A
Boana_maculateralis	A
Boana_tetete	A
Boana_alfaroi	A
Boana_dentei	A
Boana_almendarizae	A
Boana_calcarata	A
Boana_albopunctata	A
Boana_multifasciata	A
Boana_lanciformis	A
Boana_raniceps	A
Boana_heilprini	A
Boana_picturata	A
Boana_lemai	A
Boana_benitezi	A
Boana_ornatissima	A
Boana_microderma	S
Boana_nympha	A
Boana_roraima	A
Boana_geographica	A
Boana_semilineata	A
Boana_boans	A
Boana_punctata	A
Boana_cinerascens	A
Boana_sibleszi	A
Aplastodiscus_leucopygius	A
Aplastodiscus_cavicola	A
Aplastodiscus_albosignatus	A
Aplastodiscus_cochranae	A
Aplastodiscus_perviridis	A
Aplastodiscus_weygoldti	A
Aplastodiscus_arildae	A
Aplastodiscus_eugenioi	A
Aplastodiscus_albofrenatus	A
Bokermannohyla_circumdata	A
Bokermannohyla_hylax	A
Bokermannohyla_astartea	A
Bokermannohyla_martinsi	A
Bokermannohyla_itapoty	A
Bokermannohyla_oxente	A
Hyloscirtus_pacha	A
Hyloscirtus_staufferorum	A
Hyloscirtus_criptico	A
Hyloscirtus_psarolaimus	A
Hyloscirtus_tigrinus	A
Hyloscirtus_ptychodactylus	A
Hyloscirtus_princecharlesi	A
Hyloscirtus_larinopygion	A
Hyloscirtus_pantostictus	A
Hyloscirtus_lindae	A
Hyloscirtus_tapichalaca	A
Hyloscirtus_armatus	A
Hyloscirtus_charazani	A
Hyloscirtus_simmonsi	S
Hyloscirtus_alytolylax	S
Hyloscirtus_colymba	A
Hyloscirtus_phyllognathus	-
Hyloscirtus_lascinius	-
Hyloscirtus_palmeri	-
Myersiohyla_inparquesi	A
Nesorohyla_kanaima	A
Ranoidea_maini	A
Ranoidea_maculosa	A
Ranoidea_longipes	A
Ranoidea_vagitus	A
Ranoidea_cultripes	A
Ranoidea_manya	A
Ranoidea_cryptotis	A
Ranoidea_brevipes	A
Ranoidea_verrucosa	A
Ranoidea_novaehollandiae	A
Ranoidea_australis	A
Ranoidea_alboguttata	A
Ranoidea_platycephala	A
Ranoidea_dahlii	A
Ranoidea_phyllochroa	A
Ranoidea_nudidigita	A
Ranoidea_barringtonensis	A
Ranoidea_pearsoniana	A
Ranoidea_subglandulosa	A
Ranoidea_daviesae	A
Ranoidea_spenceri	A
Ranoidea_citropa	A
Litoria_thesaurensis	A
Ranoidea_impura	A
Ranoidea_moorei	A
Ranoidea_cyclorhynchus	A
Ranoidea_aurea	A
Ranoidea_raniformis	A
Ranoidea_nyakalensis	A
Ranoidea_rheocola	A
Ranoidea_nannotis	A
Ranoidea_dayi	A
Ranoidea_exopthalmia	A
Ranoidea_serrata	A
Ranoidea_genimaculata	A
Ranoidea_eucnemis	A
Ranoidea_wilcoxii	A
Ranoidea_jungguy	A
Ranoidea_booroolongensis	A
Ranoidea_lesueurii	A
Ranoidea_andiirrmalin	A
Ranoidea_gilleni	A
Ranoidea_caerulea	A
Ranoidea_splendida	A
Ranoidea_cavernicola	A
Ranoidea_xanthomera	A
Ranoidea_chloris	A
Ranoidea_gracilenta	A
Ranoidea_kumae	A
Nyctimystes_foricula	A
Nyctimystes_semipalmatus	A
Nyctimystes_zweifeli	A
Nyctimystes_humeralis	A
Nyctimystes_papua	A
Nyctimystes_pulcher	A
Nyctimystes_cheesmani	A
Nyctimystes_narinosus	A
Nyctimystes_kubori	A
Nyctimystes_brevipalmatus	A
Nyctimystes_infrafrenatus	A
Nyctimystes_dux	A
Litoria_amboinensis	A
Litoria_darlingtoni	A
Litoria_peronii	A
Litoria_tyleri	A
Litoria_rothii	A
Litoria_rubella	A
Litoria_electrica	A
Litoria_dentata	A
Litoria_congenita	A
Litoria_paraewingi	A
Litoria_verreauxii	A
Litoria_revelata	A
Litoria_littlejohni	A
Litoria_ewingii	A
Litoria_jervisiensis	A
Litoria_burrowsi	A
Litoria_adelaidensis	A
Litoria_freycineti	A
Litoria_latopalmata	A
Litoria_tornieri	A
Litoria_pallida	A
Litoria_inermis	A
Litoria_nasuta	A
Litoria_watjulumensis	A
Litoria_coplandi	A
Litoria_nigrofrenata	A
Litoria_personata	A
Litoria_longirostris	S
Litoria_meiriana	A
Litoria_microbelos	A
Litoria_dorsalis	A
Litoria_modica	A
Litoria_angiana	A
Litoria_micromembrana	A
Litoria_arfakiana	A
Litoria_wollastoni	A
Litoria_leucova	S
Litoria_majikthise	S
Litoria_iris	S
Litoria_pronimia	S
Litoria_spartacus	A
Litoria_multiplica	S
Litoria_havina	S
Litoria_nigropunctata	A
Litoria_prora	S
Litoria_bicolor	A
Litoria_fallax	A
Litoria_olongburensis	A
Pithecopus_oreades	S
Pithecopus_centralis	S
Pithecopus_ayeaye	S
Pithecopus_megacephalus	S
Pithecopus_rohdei	S
Pithecopus_azureus	S
Pithecopus_hypochondrialis	S
Pithecopus_nordestinus	S
Pithecopus_palliatus	S
Callimedusa_duellmani	S
Callimedusa_baltea	S
Callimedusa_ecuatoriana	S
Callimedusa_perinesos	S
Callimedusa_atelopoides	S
Callimedusa_tomopterna	S
Phyllomedusa_tetraploidea	S
Phyllomedusa_distincta	S
Phyllomedusa_iheringii	S
Phyllomedusa_burmeisteri	S
Phyllomedusa_bahiana	S
Phyllomedusa_sauvagii	S
Phyllomedusa_boliviana	S
Phyllomedusa_neildi	S
Phyllomedusa_trinitatis	S
Phyllomedusa_tarsius	S
Phyllomedusa_camba	S
Phyllomedusa_bicolor	S
Phyllomedusa_vaillantii	S
Phasmahyla_cruzi	S
Phasmahyla_guttata	S
Phasmahyla_jandaia	S
Phasmahyla_exilis	S
Phasmahyla_cochranae	S
Agalychnis_terranova	S
Agalychnis_callidryas	S
Agalychnis_moreletii	S
Agalychnis_annae	S
Agalychnis_saltator	S
Agalychnis_spurrelli	S
Agalychnis_dacnicolor	S
Agalychnis_lemur	S
Agalychnis_hulli	S
Hylomantis_aspera	S
Hylomantis_granulosa	S
Phrynomedusa_marginata	S
Cruziohyla_calcarifer	S
Alsodes_barrioi	A
Alsodes_norae	A
Alsodes_kaweshkari	A
Alsodes_igneus	A
Alsodes_gargola	A
Alsodes_neuquensis	A
Alsodes_pehuenche	A
Alsodes_hugoi	A
Alsodes_tumultuosus	A
Alsodes_coppingeri	A
Alsodes_australis	A
Alsodes_verrucosus	A
Alsodes_monticola	A
Alsodes_valdiviensis	A
Alsodes_vanzolinii	A
Alsodes_nodosus	A
Eupsophus_septentrionalis	S
Eupsophus_roseus	A
Eupsophus_nahuelbutensis	S
Eupsophus_contulmoensis	S
Eupsophus_migueli	A
Eupsophus_altor	S
Eupsophus_insularis	A
Eupsophus_calcaratus	A
Eupsophus_vertebralis	A
Eupsophus_emiliopugini	A
Limnomedusa_macroglossa	A
Hylodes_sazimai	A
Hylodes_ornatus	A
Hylodes_phyllodes	A
Hylodes_dactylocinus	A
Hylodes_perplicatus	A
Hylodes_meridionalis	A
Hylodes_nasus	A
Megaelosia_goeldii	A
Crossodactylus_schmidti	A
Crossodactylus_caramaschii	A
Batrachyla_antartandica	S
Batrachyla_taeniata	S
Batrachyla_leptopus	S
Hylorina_sylvatica	A
Atelognathus_nitoi	A
Atelognathus_patagonicus	A
Zachaenus_parvulus	T
Cycloramphus_organensis	S
Cycloramphus_boraceiensis	S
Cycloramphus_acangatan	S
Cycloramphus_eleutherodactylus	S
Cycloramphus_bandeirensis	S
Cycloramphus_fuliginosus	S
Thoropa_miliaris	S
Thoropa_taophora	S
Telmatobius_huayra	A
Telmatobius_hintoni	A
Telmatobius_gigas	A
Telmatobius_culeus	A
Telmatobius_pefauri	A
Telmatobius_marmoratus	A
Telmatobius_dankoi	A
Telmatobius_vilamensis	A
Telmatobius_yuracare	A
Telmatobius_bolivianus	A
Telmatobius_sibiricus	A
Telmatobius_simonsi	A
Telmatobius_chusmisensis	A
Telmatobius_verrucosus	A
Telmatobius_sanborni	A
Telmatobius_espadai	A
Telmatobius_truebae	A
Telmatobius_niger	A
Telmatobius_vellardi	A
Rhinoderma_darwinii	T
Insuetophrynus_acarpicus	A
Ceratophrys_ornata	A
Ceratophrys_cranwelli	A
Ceratophrys_cornuta	A
Lepidobatrachus_laevis	A
Chacophrys_pierottii	A
Pristimantis_frater	D
Pristimantis_gryllus	D
Pristimantis_elegans	D
Pristimantis_bogotensis	D
Pristimantis_taeniatus	D
Pristimantis_yukpa	D
Pristimantis_miyatai	D
Pristimantis_librarius	D
Pristimantis_ockendeni	D
Pristimantis_martiae	D
Pristimantis_zophus	D
Pristimantis_ptochus	D
Pristimantis_juanchoi	D
Pristimantis_palmeri	D
Pristimantis_unistrigatus	D
Pristimantis_ardalonychus	D
Pristimantis_ceuthospilus	D
Pristimantis_cajamarcensis	D
Pristimantis_luteolateralis	D
Pristimantis_walkeri	D
Pristimantis_parvillus	D
Pristimantis_chalceus	D
Pristimantis_pardalis	D
Pristimantis_altae	D
Pristimantis_pirrensis	D
Pristimantis_altamnis	D
Pristimantis_kichwarum	D
Pristimantis_luscombei	D
Pristimantis_yuruaniensis	D
Pristimantis_aureoventris	D
Pristimantis_jester	D
Pristimantis_saltissimus	D
Pristimantis_inguinalis	D
Pristimantis_marmoratus	D
Pristimantis_pulvinatus	D
Pristimantis_imitatrix	D
Pristimantis_lirellus	D
Pristimantis_croceoinguinis	D
Pristimantis_llojsintuta	D
Pristimantis_carvalhoi	D
Pristimantis_altamazonicus	D
Pristimantis_platydactylus	D
Pristimantis_ventrimarmoratus	D
Pristimantis_diadematus	D
Pristimantis_bambu	D
Pristimantis_simonbolivari	D
Pristimantis_orestes	D
Pristimantis_riveti	D
Pristimantis_versicolor	D
Pristimantis_phoxocephalus	D
Pristimantis_spinosus	D
Pristimantis_cryophilius	D
Pristimantis_quaquaversus	D
Pristimantis_rhabdocnemus	D
Pristimantis_wiensi	D
Pristimantis_melanogaster	D
Pristimantis_petrobardus	D
Pristimantis_simonsii	D
Pristimantis_rhodoplichus	D
Pristimantis_subsigillatus	D
Pristimantis_nyctophylax	D
Pristimantis_crucifer	D
Pristimantis_moro	D
Pristimantis_mindo	D
Pristimantis_galdi	D
Pristimantis_jorgevelosai	D
Pristimantis_acuminatus	D
Pristimantis_zeuctotylus	D
Pristimantis_schultei	D
Pristimantis_bromeliaceus	D
Pristimantis_calcarulatus	D
Pristimantis_dissimulatus	D
Pristimantis_appendiculatus	D
Pristimantis_pycnodermis	D
Pristimantis_orcesi	D
Pristimantis_inusitatus	D
Pristimantis_glandulosus	D
Pristimantis_acerus	D
Pristimantis_devillei	D
Pristimantis_surdus	D
Pristimantis_buckleyi	D
Pristimantis_vertebralis	D
Pristimantis_gentryi	D
Pristimantis_truebae	D
Pristimantis_curtipes	D
Pristimantis_duellmani	D
Pristimantis_quinquagesimus	D
Pristimantis_thymalopsoides	D
Pristimantis_ocreatus	D
Pristimantis_thymelensis	D
Pristimantis_pyrrhomerus	D
Pristimantis_leoni	D
Pristimantis_celator	D
Pristimantis_verecundus	D
Pristimantis_jubatus	D
Pristimantis_hectus	D
Pristimantis_brevifrons	D
Pristimantis_angustilineatus	D
Pristimantis_myops	D
Pristimantis_quantus	D
Pristimantis_uranobates	D
Pristimantis_permixtus	D
Pristimantis_acatallelus	D
Pristimantis_boulengeri	D
Pristimantis_simoterus	D
Pristimantis_chloronotus	D
Pristimantis_supernatis	D
Pristimantis_eriphus	D
Pristimantis_rozei	D
Pristimantis_urichi	D
Pristimantis_prolatus	D
Pristimantis_suetus	D
Pristimantis_conspicillatus	D
Pristimantis_buccinator	D
Pristimantis_condor	D
Pristimantis_malkini	D
Pristimantis_citriogaster	D
Pristimantis_lymani	D
Pristimantis_achatinus	D
Pristimantis_bipunctatus	D
Pristimantis_skydmainos	D
Pristimantis_koehleri	D
Pristimantis_fenestratus	D
Pristimantis_samaipatae	D
Pristimantis_chiastonotus	D
Pristimantis_incertus	D
Pristimantis_gutturalis	D
Pristimantis_ramagii	D
Pristimantis_gaigei	D
Pristimantis_lynchi	D
Pristimantis_carranguerorum	D
Pristimantis_nervicus	D
Pristimantis_affinis	D
Pristimantis_savagei	D
Pristimantis_lutitus	D
Pristimantis_merostictus	D
Pristimantis_anolirex	D
Pristimantis_euphronides	D
Pristimantis_shrevei	D
Pristimantis_nicefori	D
Pristimantis_danae	D
Pristimantis_sagittulus	D
Pristimantis_rhabdolaemus	D
Pristimantis_toftae	D
Pristimantis_stictogaster	D
Pristimantis_aniptopalmatus	D
Pristimantis_reichlei	D
Pristimantis_peruvianus	D
Pristimantis_paramerus	D
Pristimantis_conservatio	D
Pristimantis_pleurostriatus	D
Pristimantis_caprifer	D
Pristimantis_latidiscus	D
Pristimantis_colomai	D
Pristimantis_museosus	D
Pristimantis_erythropleura	D
Pristimantis_paisa	D
Pristimantis_cerasinus	D
Pristimantis_viejas	D
Pristimantis_cruentus	D
Pristimantis_caryophyllaceus	D
Pristimantis_kelephus	D
Pristimantis_calcaratus	D
Pristimantis_cremnobates	D
Pristimantis_ridens	D
Pristimantis_lanthanites	D
Pristimantis_thectopternus	D
Pristimantis_actites	D
Pristimantis_w-nigrum	D
Pristimantis_labiosus	D
Pristimantis_crenunguis	D
Yunganastes_ashkapara	D
Yunganastes_pluvicanorus	D
Yunganastes_mercedesae	D
Yunganastes_bisignatus	D
Yunganastes_fraudator	D
Oreobates_barituensis	D
Oreobates_discoidalis	D
Oreobates_ibischi	D
Oreobates_madidi	D
Oreobates_cruralis	D
Oreobates_remotus	D
Oreobates_heterodactylus	D
Oreobates_sanderi	D
Oreobates_granulosus	D
Oreobates_choristolemma	D
Oreobates_sanctaecrucis	D
Oreobates_lehri	D
Oreobates_gemcare	D
Oreobates_machiguenga	D
Oreobates_pereger	D
Oreobates_ayacucho	D
Oreobates_quixensis	D
Oreobates_saxatilis	D
Oreobates_lundbergi	D
Lynchius_parkeri	D
Lynchius_flavomaculatus	D
Lynchius_nebulanastes	D
Lynchius_simmonsi	D
Phrynopus_kauneorum	D
Phrynopus_juninensis	D
Phrynopus_tautzorum	D
Phrynopus_pesantesi	D
Phrynopus_horstpauli	D
Phrynopus_barthlenae	D
Phrynopus_bufoides	D
Phrynopus_bracki	D
Phrynopus_heimorum	D
Niceforonia_elassodiscus	D
Niceforonia_peraccai	D
Niceforonia_brunnea	D
Niceforonia_dolops	D
Euparkerella_cochranae	D
Euparkerella_brasiliensis	D
Euparkerella_tridactyla	D
Euparkerella_robusta	D
Holoaden_luederwaldti	D
Holoaden_bradei	D
Microkayla_wettsteini	D
Microkayla_iatamasi	D
Noblella_peruviana	D
Bryophryne_cophites	D
Noblella_heyeri	D
Noblella_myrmecoides	D
Noblella_lochites	D
Barycholos_ternetzi	D
Barycholos_pulcher	D
Eleutherodactylus_bilineatus	D
Strabomantis_anomalus	D
Strabomantis_bufoniformis	D
Strabomantis_necerus	D
Strabomantis_sulcatus	D
Strabomantis_biporcatus	D
Craugastor_crassidigitus	D
Craugastor_talamancae	D
Craugastor_fitzingeri	D
Craugastor_raniformis	D
Craugastor_longirostris	D
Craugastor_tabasarae	D
Craugastor_cuaquero	D
Craugastor_andi	D
Craugastor_melanostictus	D
Craugastor_emcelae	D
Craugastor_rugulosus	D
Craugastor_evanesco	D
Craugastor_ranoides	D
Craugastor_fleischmanni	D
Craugastor_rupinius	D
Craugastor_angelicus	D
Craugastor_obesus	D
Craugastor_punctariolus	D
Craugastor_megacephalus	D
Craugastor_sandersoni	D
Craugastor_lauraster	D
Craugastor_stejnegerianus	D
Craugastor_persimilis	D
Craugastor_polyptychus	D
Craugastor_underwoodi	D
Craugastor_bransfordii	D
Craugastor_podiciferus	D
Craugastor_loki	D
Craugastor_rhodopis	D
Craugastor_saltator	D
Craugastor_mexicanus	D
Craugastor_pygmaeus	D
Craugastor_lineatus	D
Craugastor_chac	D
Craugastor_laticeps	D
Craugastor_noblei	D
Craugastor_mimus	D
Craugastor_gollmeri	D
Craugastor_bocourti	D
Craugastor_spatulatus	D
Craugastor_stuarti	D
Craugastor_uno	D
Craugastor_alfredi	D
Craugastor_tarahumaraensis	D
Craugastor_augusti	D
Craugastor_daryi	D
Craugastor_trachydermus	D
Haddadus_binotatus	D
Haddadus_aramunha	D
Eleutherodactylus_planirostris	D
Eleutherodactylus_casparii	D
Eleutherodactylus_guanahacabibes	D
Eleutherodactylus_simulans	D
Eleutherodactylus_tonyi	D
Eleutherodactylus_rogersi	D
Eleutherodactylus_goini	D
Eleutherodactylus_blairhedgesi	D
Eleutherodactylus_thomasi	D
Eleutherodactylus_pinarensis	D
Eleutherodactylus_adelus	D
Eleutherodactylus_pezopetrus	D
Eleutherodactylus_jaumei	D
Eleutherodactylus_limbatus	D
Eleutherodactylus_iberia	D
Eleutherodactylus_orientalis	D
Eleutherodactylus_cubanus	D
Eleutherodactylus_etheridgei	D
Eleutherodactylus_varleyi	D
Eleutherodactylus_intermedius	D
Eleutherodactylus_feichtingeri	D
Eleutherodactylus_atkinsi	D
Eleutherodactylus_armstrongi	D
Eleutherodactylus_alcoae	D
Eleutherodactylus_leoncei	D
Eleutherodactylus_darlingtoni	D
Eleutherodactylus_gossei	D
Eleutherodactylus_fuscus	D
Eleutherodactylus_orcutti	D
Eleutherodactylus_junori	D
Eleutherodactylus_nubicola	D
Eleutherodactylus_alticola	D
Eleutherodactylus_andrewsi	D
Eleutherodactylus_griphus	D
Eleutherodactylus_glaucoreius	D
Eleutherodactylus_cundalli	D
Eleutherodactylus_pantoni	D
Eleutherodactylus_pentasyringos	D
Eleutherodactylus_jamaicensis	D
Eleutherodactylus_luteolus	D
Eleutherodactylus_grabhami	D
Eleutherodactylus_cavernicola	D
Eleutherodactylus_sisyphodemus	D
Eleutherodactylus_gundlachi	D
Eleutherodactylus_riparius	D
Eleutherodactylus_rivularis	D
Eleutherodactylus_toa	D
Eleutherodactylus_turquinensis	D
Eleutherodactylus_cuneatus	D
Eleutherodactylus_weinlandi	D
Eleutherodactylus_rhodesi	D
Eleutherodactylus_grahami	D
Eleutherodactylus_pictissimus	D
Eleutherodactylus_lentus	D
Eleutherodactylus_monensis	D
Eleutherodactylus_probolaeus	D
Eleutherodactylus_ricordii	D
Eleutherodactylus_bresslerae	D
Eleutherodactylus_acmonis	D
Eleutherodactylus_greyi	D
Eleutherodactylus_emiliae	D
Eleutherodactylus_dimidiatus	D
Eleutherodactylus_albipes	D
Eleutherodactylus_maestrensis	D
Eleutherodactylus_schmidti	D
Eleutherodactylus_caribe	D
Eleutherodactylus_eunaster	D
Eleutherodactylus_corona	D
Eleutherodactylus_heminota	D
Eleutherodactylus_amadeus	D
Eleutherodactylus_dolomedes	D
Eleutherodactylus_glaphycompus	D
Eleutherodactylus_thorectes	D
Eleutherodactylus_bakeri	D
Eleutherodactylus_jugans	D
Eleutherodactylus_apostates	D
Eleutherodactylus_oxyrhyncus	D
Eleutherodactylus_furcyensis	D
Eleutherodactylus_rufifemoralis	D
Eleutherodactylus_glanduliferoides	D
Eleutherodactylus_paulsoni	D
Eleutherodactylus_brevirostris	D
Eleutherodactylus_ventrilineatus	D
Eleutherodactylus_sciagraphus	D
Eleutherodactylus_glandulifer	D
Eleutherodactylus_klinikowskii	D
Eleutherodactylus_zugi	D
Eleutherodactylus_pipilans	D
Eleutherodactylus_nitidus	D
Eleutherodactylus_cystignathoides	D
Eleutherodactylus_marnockii	D
Eleutherodactylus_zeus	D
Eleutherodactylus_symingtoni	D
Eleutherodactylus_schwartzi	D
Eleutherodactylus_coqui	D
Eleutherodactylus_portoricensis	D
Eleutherodactylus_wightmanae	D
Eleutherodactylus_gryllus	D
Eleutherodactylus_cochranae	D
Eleutherodactylus_hedricki	D
Eleutherodactylus_brittoni	D
Eleutherodactylus_antillensis	D
Eleutherodactylus_locustus	D
Eleutherodactylus_eneidae	D
Eleutherodactylus_cooki	D
Eleutherodactylus_flavescens	D
Eleutherodactylus_martinicensis	D
Eleutherodactylus_amplinympha	D
Eleutherodactylus_johnstonei	D
Eleutherodactylus_pinchoni	D
Eleutherodactylus_barlagnei	D
Eleutherodactylus_auriculatus	D
Eleutherodactylus_principalis	D
Eleutherodactylus_glamyrus	D
Eleutherodactylus_bartonsmithi	D
Eleutherodactylus_mariposa	D
Eleutherodactylus_ronaldi	D
Eleutherodactylus_eileenae	D
Eleutherodactylus_audanti	D
Eleutherodactylus_parabates	D
Eleutherodactylus_haitianus	D
Eleutherodactylus_abbotti	D
Eleutherodactylus_pituinus	D
Eleutherodactylus_poolei	D
Eleutherodactylus_minutus	D
Eleutherodactylus_guantanamera	D
Eleutherodactylus_ionthus	D
Eleutherodactylus_varians	D
Eleutherodactylus_leberi	D
Eleutherodactylus_melacara	D
Eleutherodactylus_sommeri	D
Eleutherodactylus_wetmorei	D
Eleutherodactylus_montanus	D
Eleutherodactylus_patriciae	D
Eleutherodactylus_auriculatoides	D
Eleutherodactylus_lamprotes	D
Eleutherodactylus_fowleri	D
Eleutherodactylus_unicolor	D
Eleutherodactylus_richmondi	D
Eleutherodactylus_counouspeus	D
Eleutherodactylus_ruthae	D
Eleutherodactylus_bothroboans	D
Eleutherodactylus_parapelates	D
Eleutherodactylus_hypostenor	D
Eleutherodactylus_nortoni	D
Eleutherodactylus_chlorophenax	D
Eleutherodactylus_inoptatus	D
Diasporus_citrinobapheus	D
Diasporus_quidditus	D
Diasporus_diastema	D
Diasporus_hylaeformis	D
Diasporus_vocator	D
Adelophryne_maranguapensis	D
Adelophryne_baturitensis	D
Adelophryne_pachydactyla	D
Adelophryne_patamona	D
Adelophryne_gutturosa	D
Adelophryne_adiastola	D
Phyzelaphryne_miriamae	D
Ischnocnema_nasuta	D
Ischnocnema_izecksohni	D
Ischnocnema_henselii	D
Ischnocnema_guentheri	D
Ischnocnema_oea	D
Ischnocnema_erythromera	D
Ischnocnema_venancioi	D
Ischnocnema_hoehnei	D
Ischnocnema_parva	D
Ischnocnema_octavioi	D
Ischnocnema_verrucosa	D
Ischnocnema_bolbodactyla	D
Ischnocnema_abdita	D
Ischnocnema_juipoca	D
Ischnocnema_vizottoi	D
Ischnocnema_concolor	D
Ischnocnema_spanios	D
Ischnocnema_melanopygia	D
Ischnocnema_lactea	D
Ischnocnema_holti	D
Ischnocnema_sambaqui	D
Ischnocnema_nanahallux	D
Brachycephalus_nodoterga	D
Brachycephalus_toby	D
Brachycephalus_pitanga	D
Brachycephalus_vertebralis	D
Brachycephalus_hermogenesi	D
Brachycephalus_alipioi	D
Brachycephalus_ephippium	D
Brachycephalus_didactylus	D
Brachycephalus_pernix	D
Brachycephalus_ferruginus	D
Brachycephalus_pombali	D
Brachycephalus_izecksohni	D
Brachycephalus_brunneus	D
Gastrotheca_coeruleomaculatus	D
Gastrotheca_christiani	S
Gastrotheca_gracilis	S
Gastrotheca_chrysosticta	S
Gastrotheca_griswoldi	D
Gastrotheca_marsupiata	S
Gastrotheca_lateonota	S
Gastrotheca_pseustes	S
Gastrotheca_peruana	S
Gastrotheca_zeugocystis	D
Gastrotheca_excubitor	D
Gastrotheca_ochoai	D
Gastrotheca_rebeccae	D
Gastrotheca_pachachacae	D
Gastrotheca_antoniiochoai	D
Gastrotheca_psychrophila	S
Gastrotheca_stictopleura	S
Gastrotheca_atympana	D
Gastrotheca_testudinea	D
Gastrotheca_nebulanastes	D
Gastrotheca_galeata	D
Gastrotheca_argenteovirens	S
Gastrotheca_trachyceps	S
Gastrotheca_aureomaculata	S
Gastrotheca_ruizi	S
Gastrotheca_dunni	S
Gastrotheca_riobambae	S
Gastrotheca_nicefori	D
Gastrotheca_ovifera	D
Gastrotheca_orophylax	D
Gastrotheca_plumbea	D
Gastrotheca_litonedis	S
Gastrotheca_monticola	S
Gastrotheca_microdiscus	D
Gastrotheca_fulvorufa	D
Gastrotheca_ernestoi	D
Gastrotheca_albolineata	D
Gastrotheca_dendronastes	D
Gastrotheca_cornuta	D
Gastrotheca_longipes	D
Gastrotheca_helenae	D
Gastrotheca_guentheri	D
Gastrotheca_weinlandii	D
Gastrotheca_walkeri	D
Gastrotheca_fissipes	D
Gastrotheca_prasina	D
Gastrotheca_recava	D
Gastrotheca_pulchra	D
Fritziana_ohausi	S
Fritziana_fissilis	S
Fritziana_goeldii	S
Stefania_coxi	D
Stefania_ayangannae	D
Stefania_riveroi	D
Stefania_riae	D
Stefania_scalae	D
Stefania_evansi	D
Stefania_woodleyi	D
Stefania_roraimae	D
Stefania_schuberti	D
Stefania_satelles	D
Stefania_ginesi	D
Flectonotus_pygmaeus	S
Flectonotus_fitzgeraldi	S
Hemiphractus_proboscideus	D
Hemiphractus_bubalus	D
Hemiphractus_fasciatus	D
Hemiphractus_scutatus	D
Hemiphractus_helioi	D
Cryptobatrachus_boulengeri	D
Ranitomeya_fantastica	S
Ranitomeya_summersi	S
Ranitomeya_benedicta	S
Ranitomeya_uakarii	S
Ranitomeya_reticulata	S
Ranitomeya_ventrimaculata	S
Ranitomeya_amazonica	S
Ranitomeya_variabilis	A
Ranitomeya_toraro	S
Ranitomeya_defleri	S
Ranitomeya_flavovittata	S
Ranitomeya_vanzolinii	S
Ranitomeya_imitator	S
Ranitomeya_sirensis	S
Andinobates_virolinensis	S
Andinobates_tolimensis	S
Andinobates_bombetes	S
Andinobates_opisthomelas	S
Andinobates_cassidyhornae	S
Andinobates_dorisswansonae	S
Andinobates_claudiae	S
Andinobates_minutus	S
Andinobates_fulguritus	S
Excidobates_mysteriosus	S
Excidobates_condor	S
Excidobates_captivus	S
Oophaga_vicentei	S
Oophaga_pumilio	S
Oophaga_speciosa	S
Oophaga_arborea	S
Oophaga_sylvatica	S
Oophaga_lehmanni	S
Oophaga_histrionica	S
Oophaga_granulifera	S
Dendrobates_auratus	S
Dendrobates_truncatus	S
Dendrobates_tinctorius	S
Dendrobates_leucomelas	S
Adelphobates_galactonotus	S
Adelphobates_castaneoticus	S
Adelphobates_quinquevittatus	S
Minyobates_steyermarki	S
Phyllobates_terribilis	S
Phyllobates_aurotaenia	S
Phyllobates_bicolor	S
Phyllobates_vittatus	S
Phyllobates_lugubris	S
Hyloxalus_toachi	S
Hyloxalus_awa	S
Hyloxalus_infraguttatus	S
Hyloxalus_elachyhistus	S
Hyloxalus_insulatus	S
Hyloxalus_idiomelus	S
Hyloxalus_azureiventris	S
Hyloxalus_chlorocraspedus	S
Hyloxalus_craspedoceps	S
Hyloxalus_nexipus	S
Hyloxalus_sylvaticus	S
Hyloxalus_pulcherrimus	S
Hyloxalus_anthracinus	S
Hyloxalus_pulchellus	S
Hyloxalus_delatorreae	S
Hyloxalus_vertebralis	S
Hyloxalus_italoi	S
Hyloxalus_maculosus	S
Hyloxalus_yasuni	S
Hyloxalus_bocagei	S
Hyloxalus_sauli	S
Hyloxalus_sordidatus	S
Hyloxalus_leucophaeus	S
Hyloxalus_subpunctatus	S
Ameerega_altamazonica	S
Ameerega_rubriventris	S
Ameerega_macero	S
Ameerega_cainarachi	S
Ameerega_petersi	S
Ameerega_trivittata	S
Ameerega_pulchripecta	S
Ameerega_simulans	S
Ameerega_hahneli	S
Ameerega_picta	S
Ameerega_flavopicta	S
Ameerega_braccata	S
Ameerega_pepperi	S
Ameerega_ignipedis	S
Ameerega_yoshina	S
Ameerega_bassleri	S
Ameerega_bilinguis	S
Ameerega_parvula	S
Ameerega_pongoensis	S
Ameerega_silverstonei	S
Leucostethus_argyrogaster	S
Leucostethus_fugax	S
Leucostethus_fraterdanieli	S
Colostethus_inguinalis	S
Colostethus_panamansis	S
Colostethus_imbricolus	S
Colostethus_pratti	S
Colostethus_latinasus	S
Epipedobates_anthonyi	S
Epipedobates_tricolor	S
Epipedobates_machalilla	S
Epipedobates_espinosai	S
Epipedobates_boulengeri	S
Silverstoneia_flotator	S
Silverstoneia_nubicola	S
Mannophryne_larandina	S
Mannophryne_herminae	S
Mannophryne_yustizi	S
Mannophryne_lamarcai	S
Mannophryne_collaris	S
Mannophryne_cordilleriana	S
Mannophryne_caquetio	S
Mannophryne_venezuelensis	S
Mannophryne_trinitatis	S
Mannophryne_leonardoi	S
Mannophryne_riveroi	S
Mannophryne_olmonae	S
Mannophryne_oblitterata	S
Aromobates_cannatellai	S
Aromobates_saltuensis	S
Aromobates_ericksonae	S
Aromobates_meridensis	S
Aromobates_molinarii	S
Aromobates_nocturnus	S
Aromobates_ornatissimus	S
Anomaloglossus_kaiei	S
Anomaloglossus_degranvillei	T
Anomaloglossus_praderioi	S
Anomaloglossus_beebei	S
Anomaloglossus_roraima	S
Anomaloglossus_rufulus	S
Anomaloglossus_tepuyensis	S
Anomaloglossus_baeobatrachus	S
Anomaloglossus_stepheni	T
Anomaloglossus_verbeeksnyderorum	S
Anomaloglossus_wothuja	S
Rheobates_palmatus	S
Allobates_sumtuosus	S
Allobates_paleovarzensis	S
Allobates_trilineatus	S
Allobates_humilis	S
Allobates_pittieri	S
Allobates_chalcopis	T
Allobates_subfolionidificans	S
Allobates_conspicuus	S
Allobates_insperatus	S
Allobates_grillisimilis	S
Allobates_ornatus	T
Allobates_algorei	S
Allobates_granti	S
Allobates_marchesianus	S
Allobates_gasconi	S
Allobates_caeruleodactylus	S
Allobates_juanii	S
Allobates_femoralis	S
Allobates_zaparo	S
Allobates_hodli	S
Allobates_nidicola	T
Allobates_masniger	S
Allobates_brunneus	S
Allobates_crombiei	S
Allobates_kingsburyi	S
Allobates_talamancae	S
Allobates_undulatus	S
Uperoleia_inundata	A
Uperoleia_crassa	A
Uperoleia_russelli	A
Uperoleia_talpa	A
Uperoleia_borealis	A
Uperoleia_mjobergii	A
Uperoleia_micromeles	A
Uperoleia_micra	A
Uperoleia_trachyderma	A
Uperoleia_lithomoda	A
Uperoleia_aspera	A
Uperoleia_minima	A
Uperoleia_glandulosa	A
Uperoleia_littlejohni	A
Uperoleia_altissima	A
Uperoleia_rugosa	A
Uperoleia_fusca	A
Uperoleia_laevigata	A
Uperoleia_tyleri	A
Spicospina_flammocaerulea	A
Metacrinia_nichollsi	D
Arenophryne_rotunda	D
Myobatrachus_gouldii	D
Pseudophryne_coriacea	S
Pseudophryne_bibronii	S
Crinia_pseudinsignifera	A
Crinia_subinsignifera	A
Crinia_insignifera	A
Crinia_sloanei	A
Crinia_glauerti	A
Crinia_georgiana	A
Crinia_flindersensis	A
Crinia_riparia	A
Crinia_signifera	A
Crinia_parinsignifera	A
Crinia_tinnula	A
Crinia_deserticola	A
Crinia_bilingua	A
Crinia_remota	A
Crinia_fimbriata	A
Crinia_tasmaniensis	A
Crinia_nimbus	D
Assa_darlingtoni	T
Geocrinia_victoriana	S
Paracrinia_haswelli	A
Taudactylus_acutirostris	A
Mixophyes_coggeri	S
Mixophyes_carbinensis	S
Mixophyes_schevilli	S
Mixophyes_balbus	A
Mixophyes_fasciolatus	S
Rheobatrachus_silus	T
Limnodynastes_interioris	S
Limnodynastes_dumerilii	S
Limnodynastes_terraereginae	S
Limnodynastes_dorsalis	S
Limnodynastes_tasmaniensis	S
Limnodynastes_peronii	S
Limnodynastes_fletcheri	S
Limnodynastes_depressus	S
Limnodynastes_salmini	S
Limnodynastes_lignarius	S
Limnodynastes_convexiusculus	S
Philoria_sphagnicolus	T
Adelotus_brevis	S
Lechriodus_melanopyga	S
Platyplectrum_ornatum	S
Lechriodus_fletcheri	S
Platyplectrum_spenceri	S
Neobatrachus_sudelli	A
Neobatrachus_pictus	A
Neobatrachus_pelobatoides	A
Heleioporus_australiacus	S
Notaden_bennettii	A
Notaden_melanoscaphus	A
Telmatobufo_australis	A
Telmatobufo_venustus	A
Telmatobufo_bullocki	A
Calyptocephalella_gayi	A
Pseudophilautus_wynaadensis	D
Pseudophilautus_leucorhinus	D
Pseudophilautus_amboli	D
Pseudophilautus_kani	D
Pseudophilautus_folicola	D
Pseudophilautus_simba	D
Pseudophilautus_schneideri	D
Pseudophilautus_limbus	D
Pseudophilautus_zorro	D
Pseudophilautus_asankai	D
Pseudophilautus_hoffmanni	D
Pseudophilautus_pleurotaenia	D
Pseudophilautus_ocularis	D
Pseudophilautus_mittermeieri	D
Pseudophilautus_decoris	D
Pseudophilautus_tanu	D
Pseudophilautus_hankeni	D
Pseudophilautus_schmarda	D
Pseudophilautus_lunatus	D
Pseudophilautus_sarasinorum	D
Pseudophilautus_stuarti	D
Pseudophilautus_alto	D
Pseudophilautus_popularis	D
Pseudophilautus_cavirostris	D
Pseudophilautus_femoralis	D
Pseudophilautus_poppiae	D
Pseudophilautus_mooreorum	D
Pseudophilautus_stellatus	D
Pseudophilautus_reticulatus	D
Pseudophilautus_papillosus	D
Pseudophilautus_steineri	D
Pseudophilautus_microtympanum	D
Mercurana_myristicapalustris	S
Raorchestes_munnarensis	D
Raorchestes_beddomii	D
Raorchestes_resplendens	D
Raorchestes_dubois	D
Raorchestes_luteolus	D
Raorchestes_travancoricus	D
Raorchestes_chlorosomma	D
Raorchestes_kaikatti	D
Raorchestes_sushili	D
Raorchestes_anili	D
Raorchestes_chotta	D
Raorchestes_jayarami	D
Raorchestes_glandulosus	D
Raorchestes_bobingeri	D
Raorchestes_akroparallagi	D
Raorchestes_graminirupes	D
Raorchestes_nerostagona	D
Raorchestes_griet	D
Raorchestes_charius	D
Raorchestes_coonoorensis	D
Raorchestes_tinniens	D
Raorchestes_signatus	D
Raorchestes_chromasynchysi	D
Raorchestes_marki	D
Raorchestes_gryllus	D
Raorchestes_menglaensis	D
Raorchestes_longchuanensis	D
Raorchestes_tuberohumerus	D
Raorchestes_bombayensis	D
Raorchestes_ghatei	D
Raorchestes_ponmudi	D
Beddomixalus_bijui	S
Kurixalus_odontotarsus	S
Kurixalus_bisacculus	S
Kurixalus_verrucosus	S
Kurixalus_banaensis	S
Kurixalus_eiffingeri	S
Kurixalus_idiootocus	S
Kurixalus_appendiculatus	S
Theloderma_moloch	S
Philautus_mjobergi	D
Philautus_amoenus	D
Philautus_umbra	D
Philautus_juliandringi	D
Philautus_acutirostris	D
Philautus_surdus	D
Philautus_worcesteri	D
Philautus_petersi	D
Philautus_refugii	D
Philautus_kakipanjang	D
Philautus_disgregus	D
Philautus_davidlabangi	D
Philautus_bunitus	D
Philautus_kerangae	D
Philautus_acutus	D
Philautus_aurantium	D
Philautus_abditus	D
Philautus_aurifasciatus	D
Philautus_everetti	D
Philautus_macroscelis	D
Philautus_hosii	D
Philautus_ingeri	D
Philautus_tectus	D
Gracixalus_waza	S
Gracixalus_nonggangensis	S
Gracixalus_ananjevae	S
Gracixalus_jinxiuensis	S
Gracixalus_carinensis	S
Gracixalus_quangi	S
Gracixalus_supercornutus	S
Gracixalus_gracilipes	S
Gracixalus_quyeti	S
Rhacophorus_vampyrus	S
Zhangixalus_minimus	S
Zhangixalus_hongchibaensis	S
Zhangixalus_moltrechti	S
Zhangixalus_hungfuensis	S
Zhangixalus_wui	S
Zhangixalus_hui	S
Zhangixalus_puerensis	S
Zhangixalus_dugritei	S
Zhangixalus_omeimontis	S
Zhangixalus_duboisi	S
Zhangixalus_burmanus	S
Zhangixalus_schlegelii	S
Zhangixalus_arboreus	S
Zhangixalus_chenfui	S
Zhangixalus_nigropunctatus	S
Zhangixalus_dorsoviridis	S
Zhangixalus_smaragdinus	S
Zhangixalus_feae	S
Zhangixalus_dennysi	S
Leptomantis_gauni	S
Leptomantis_belalongensis	S
Leptomantis_gadingensis	S
Leptomantis_bimaculatus	S
Leptomantis_angulirostris	S
Leptomantis_penanorum	S
Leptomantis_harrissoni	S
Leptomantis_fasciatus	S
Leptomantis_rufipes	S
Rhacophorus_monticola	S
Leptomantis_cyanopunctatus	S
Rhacophorus_exechopygus	S
Rhacophorus_annamensis	S
Rhacophorus_verrucopus	S
Rhacophorus_orlovi	S
Rhacophorus_calcaneus	S
Rhacophorus_translineatus	S
Rhacophorus_nigropalmatus	S
Rhacophorus_baluensis	S
Rhacophorus_reinwardtii	S
Rhacophorus_norhayatii	S
Rhacophorus_borneensis	S
Rhacophorus_rhodopus	S
Rhacophorus_bipunctatus	S
Rhacophorus_helenae	S
Rhacophorus_kio	S
Rhacophorus_malabaricus	S
Rhacophorus_pseudomalabaricus	S
Rhacophorus_lateralis	S
Rhacophorus_pardalis	S
Zhangixalus_dulitensis	S
Polypedates_leucomystax	S
Polypedates_teraiensis	S
Polypedates_impresus	S
Polypedates_discantus	S
Polypedates_mutus	S
Polypedates_megacephalus	S
Polypedates_braueri	S
Polypedates_macrotis	S
Polypedates_maculatus	S
Polypedates_cruciger	S
Polypedates_pseudocruciger	S
Polypedates_colletti	S
Polypedates_otilophus	S
Taruga_longinasus	S
Taruga_fastigo	S
Taruga_eques	S
Ghatixalus_asterops	S
Ghatixalus_variabilis	S
Feihyla_hansenae	S
Feihyla_vittata	S
Feihyla_inexpectata	S
Feihyla_palpebralis	S
Feihyla_kajau	S
Rhacophorus_calcadensis	S
Chiromantis_xerampelina	S
Chiromantis_petersii	S
Chiromantis_rufescens	S
Chiromantis_nongkhorensis	S
Chiromantis_doriae	S
Theloderma_gordoni	S
Theloderma_corticale	S
Theloderma_leporosum	S
Theloderma_truongsonense	S
Theloderma_nebulosum	S
Theloderma_bicolor	S
Theloderma_rhododiscus	S
Theloderma_asperum	S
Theloderma_stellatum	S
Theloderma_palliatum	S
Nyctixalus_margaritifer	S
Nyctixalus_pictus	S
Nyctixalus_spinosus	S
Liuixalus_ocellatus	A
Liuixalus_romeri	A
Liuixalus_hainanus	A
Buergeria_oxycephala	A
Buergeria_robusta	A
Buergeria_buergeri	A
Buergeria_japonica	A
Gephyromantis_runewsweeki	T
Gephyromantis_blanci	T
Gephyromantis_enki	T
Gephyromantis_boulengeri	T
Gephyromantis_eiselti	T
Gephyromantis_mafy	-
Gephyromantis_thelenae	T
Gephyromantis_verrucosus	T
Gephyromantis_hintelmannae	-
Gephyromantis_decaryi	T
Gephyromantis_leucocephalus	T
Gephyromantis_corvus	S
Gephyromantis_azzurrae	S
Gephyromantis_atsingy	-
Gephyromantis_pseudoasper	S
Gephyromantis_striatus	S
Gephyromantis_malagasius	S
Gephyromantis_horridus	S
Gephyromantis_ventrimaculatus	S
Gephyromantis_klemmeri	S
Gephyromantis_rivicola	S
Gephyromantis_silvanus	S
Gephyromantis_webbi	S
Gephyromantis_asper	S
Gephyromantis_tahotra	-
Gephyromantis_ambohitra	S
Gephyromantis_schilfi	S
Gephyromantis_tandroka	S
Gephyromantis_salegy	S
Gephyromantis_leucomaculatus	S
Gephyromantis_zavona	S
Gephyromantis_granulatus	S
Gephyromantis_moseri	S
Gephyromantis_tschenki	S
Gephyromantis_cornutus	S
Gephyromantis_redimitus	S
Gephyromantis_sculpturatus	S
Gephyromantis_luteus	S
Gephyromantis_plicifer	S
Mantidactylus_madecassus	S
Mantidactylus_curtus	S
Mantidactylus_pauliani	S
Mantidactylus_alutus	S
Mantidactylus_bellyi	S
Mantidactylus_ulcerosus	S
Mantidactylus_betsileanus	S
Mantidactylus_noralottae	S
Mantidactylus_delormei	S
Mantidactylus_brevipalmatus	S
Mantidactylus_paidroa	S
Mantidactylus_aerumnalis	S
Mantidactylus_albofrenatus	S
Mantidactylus_charlotteae	S
Mantidactylus_opiparis	S
Mantidactylus_melanopleura	S
Mantidactylus_zipperi	S
Mantidactylus_biporus	S
Mantidactylus_lugubris	S
Mantidactylus_femoralis	S
Mantidactylus_zolitschka	S
Mantidactylus_mocquardi	S
Mantidactylus_ambreensis	S
Mantidactylus_majori	S
Mantidactylus_argenteus	S
Mantidactylus_cowanii	S
Mantidactylus_grandidieri	S
Mantidactylus_guttulatus	S
Boehmantis_microtympanum	S
Spinomantis_fimbriatus	S
Spinomantis_tavaratra	S
Spinomantis_aglavei	S
Spinomantis_phantasticus	S
Spinomantis_peraccae	S
Spinomantis_elegans	S
Spinomantis_guibei	S
Spinomantis_bertini	S
Spinomantis_microtis	S
Guibemantis_pulcher	S
Guibemantis_tasifotsy	S
Guibemantis_flavobrunneus	S
Guibemantis_punctatus	S
Guibemantis_wattersoni	S
Guibemantis_liber	S
Guibemantis_methueni	S
Guibemantis_bicalcaratus	S
Guibemantis_albolineatus	S
Guibemantis_timidus	S
Guibemantis_kathrinae	S
Guibemantis_tornieri	S
Guibemantis_depressiceps	S
Blommersia_galani	S
Blommersia_dejongi	S
Blommersia_blommersae	S
Blommersia_variabilis	S
Blommersia_domerguei	S
Blommersia_wittei	S
Blommersia_sarotra	S
Blommersia_kely	S
Blommersia_grandisonae	S
Blommersia_angolafa	A
Mantella_viridis	S
Mantella_ebenaui	S
Mantella_betsileo	S
Mantella_expectata	S
Mantella_manery	S
Mantella_laevigata	S
Mantella_milotympanum	S
Mantella_crocea	S
Mantella_aurantiaca	S
Mantella_pulchra	S
Mantella_madagascariensis	S
Mantella_nigricans	S
Mantella_haraldmeieri	S
Mantella_baroni	S
Mantella_cowanii	S
Mantella_bernhardi	S
Wakea_madinika	S
Tsingymantis_antitra	A
Boophis_brachychir	A
Boophis_entingae	A
Boophis_goudotii	A
Boophis_obscurus	A
Boophis_quasiboehmei	A
Boophis_boehmei	A
Boophis_popi	A
Boophis_fayi	A
Boophis_reticulatus	A
Boophis_burgeri	A
Boophis_rufioculis	A
Boophis_axelmeyeri	A
Boophis_andohahela	A
Boophis_elenae	A
Boophis_luciae	A
Boophis_madagascariensis	A
Boophis_roseipalmatus	A
Boophis_luteus	A
Boophis_sambirano	A
Boophis_liami	A
Boophis_mandraka	A
Boophis_tampoka	A
Boophis_albipunctatus	A
Boophis_jaegeri	A
Boophis_anjanaharibeensis	A
Boophis_septentrionalis	A
Boophis_englaenderi	A
Boophis_schuboeae	A
Boophis_ankaratra	A
Boophis_andreonei	A
Boophis_sibilans	A
Boophis_blommersae	A
Boophis_feonnyala	A
Boophis_arcanus	A
Boophis_haematopus	A
Boophis_pyrrhus	A
Boophis_miniatus	A
Boophis_andrangoloaka	A
Boophis_rhodoscelis	A
Boophis_laurenti	A
Boophis_lilianae	A
Boophis_narinsi	A
Boophis_majori	A
Boophis_picturatus	A
Boophis_microtympanum	A
Boophis_williamsi	A
Boophis_ulftunni	A
Boophis_baetkei	A
Boophis_vittatus	A
Boophis_marojezensis	A
Boophis_rappiodes	A
Boophis_erythrodactylus	A
Boophis_bottae	A
Boophis_tasymena	A
Boophis_viridis	A
Boophis_periegetes	A
Boophis_occidentalis	A
Boophis_albilabris	A
Boophis_opisthodon	A
Boophis_doulioti	A
Boophis_tephraeomystax	A
Boophis_xerophilus	A
Boophis_idae	A
Boophis_calcaratus	A
Boophis_guibei	A
Boophis_lichenoides	A
Boophis_pauliani	A
Aglyptodactylus_madagascariensis	A
Aglyptodactylus_laticeps	A
Aglyptodactylus_securifer	A
Laliostoma_labrosum	A
Rana_dybowskii	A
Rana_pirica	A
Rana_ornativentris	A
Rana_kukunoris	A
Rana_chensinensis	A
Rana_huanrenensis	A
Rana_tagoi	A
Rana_sakuraii	A
Rana_coreana	A
Rana_amurensis	A
Rana_longicrus	A
Rana_culaiensis	A
Rana_zhenhaiensis	A
Rana_omeimontis	A
Rana_hanluica	A
Rana_chaochiaoensis	A
Rana_japonica	A
Rana_maoershanensis	A
Rana_sauteri	A
Rana_temporaria	A
Rana_pyrenaica	A
Rana_arvalis	A
Rana_iberica	A
Rana_italica	A
Rana_asiatica	A
Rana_macrocnemis	A
Rana_tavasensis	A
Rana_pseudodalmatina	A
Rana_dalmatina	A
Rana_latastei	A
Rana_graeca	A
Rana_ulma	A
Rana_kobai	A
Rana_tsushimensis	A
Rana_zhengi	A
Rana_johnsi	A
Rana_sierrae	A
Rana_muscosa	A
Rana_cascadae	A
Rana_aurora	A
Rana_draytonii	A
Rana_boylii	A
Rana_pretiosa	A
Rana_luteiventris	A
Rana_shuchinae	A
Lithobates_macroglossa	A
Lithobates_brownorum	A
Lithobates_taylori	A
Lithobates_forreri	A
Lithobates_yavapaiensis	A
Lithobates_onca	A
Lithobates_magnaocularis	A
Lithobates_spectabilis	A
Lithobates_tlaloci	A
Lithobates_neovolcanicus	A
Lithobates_berlandieri	A
Lithobates_blairi	A
Lithobates_sphenocephalus	A
Lithobates_omiltemanus	A
Lithobates_areolatus	A
Lithobates_palustris	A
Lithobates_capito	A
Lithobates_sevosus	A
Lithobates_fisheri	A
Lithobates_chiricahuensis	A
Lithobates_dunni	A
Lithobates_montezumae	A
Lithobates_pipiens	A
Lithobates_juliani	A
Lithobates_vaillanti	A
Lithobates_bwana	A
Lithobates_palmipes	A
Lithobates_warszewitschii	A
Lithobates_vibicarius	A
Lithobates_maculatus	A
Lithobates_tarahumarae	A
Lithobates_pustulosus	A
Lithobates_zweifeli	A
Lithobates_psilonota	A
Lithobates_sierramadrensis	A
Lithobates_sylvaticus	A
Lithobates_clamitans	A
Lithobates_okaloosae	A
Lithobates_catesbeianus	A
Lithobates_heckscheri	A
Lithobates_grylio	A
Lithobates_septentrionalis	A
Lithobates_virgatipes	A
Pseudorana_weiningensis	A
Odorrana_nasuta	A
Odorrana_versabilis	A
Odorrana_exiliversabilis	A
Odorrana_nasica	A
Odorrana_tormota	A
Odorrana_amamiensis	A
Odorrana_narina	A
Odorrana_supranarina	A
Odorrana_utsunomiyaorum	A
Odorrana_swinhoana	A
Odorrana_leporipes	A
Odorrana_chloronota	A
Odorrana_graminea	A
Odorrana_aureola	A
Odorrana_livida	A
Odorrana_hosii	A
Odorrana_morafkai	A
Odorrana_banaorum	A
Odorrana_tiannanensis	A
Odorrana_bacboensis	A
Odorrana_hainanensis	A
Odorrana_hejiangensis	A
Odorrana_nanjiangensis	A
Odorrana_schmackeri	A
Odorrana_huanggangensis	A
Odorrana_tianmuii	A
Odorrana_andersonii	A
Odorrana_jingdongensis	A
Odorrana_grahami	A
Odorrana_junlianensis	A
Odorrana_kuangwuensis	A
Odorrana_margaretae	A
Odorrana_wuchuanensis	A
Odorrana_lungshengensis	A
Odorrana_yizhangensis	A
Odorrana_anlungensis	A
Odorrana_geminata	A
Odorrana_chapaensis	A
Odorrana_ishikawae	A
Odorrana_absita	A
Odorrana_khalam	A
Nidirana_daunchina	S
Nidirana_chapaensis	S
Nidirana_okinavana	S
Nidirana_adenopleura	S
Nidirana_lini	S
Nidirana_pleuraden	S
Babina_subaspera	A
Babina_holsti	A
Pulchrana_grandocula	A
Pulchrana_similis	A
Pulchrana_melanomenta	A
Pulchrana_moellendorffi	A
Pulchrana_mangyanum	A
Pulchrana_signata	A
Pulchrana_picturata	A
Pulchrana_siberu	A
Pulchrana_banjarana	A
Pulchrana_glandulosa	A
Pulchrana_laterimaculata	A
Pulchrana_baramica	A
Pulchrana_rawa	A
Chalcorana_labialis	A
Chalcorana_parvaccola	A
Chalcorana_eschatia	A
Chalcorana_raniceps	A
Chalcorana_chalconota	A
Chalcorana_megalonesa	A
Chalcorana_rufipes	A
Chalcorana_mocquardi	A
Amnirana_lepus	A
Amnirana_albolabris	A
Amnirana_galamensis	A
Chalcorana_macrops	A
Amnirana_nicobariensis	A
Sylvirana_spinulosa	A
Sylvirana_maosonensis	A
Hylarana_latouchii	A
Sylvirana_cubitalis	A
Sylvirana_nigrovittata	A
Sylvirana_faber	A
Hydrophylax_malabaricus	A
Hydrophylax_gracilis	A
Hylarana_attigua	A
Indosylvirana_milleti	A
Papurana_arfaki	A
Papurana_jimiensis	A
Papurana_papua	A
Papurana_daemeli	A
Hydrophylax_leptoglossa	A
Indosylvirana_temporalis	A
Indosylvirana_aurantiaca	A
Hylarana_lateralis	A
Humerana_miopus	A
Sylvirana_guentheri	A
Hylarana_macrodactyla	A
Hylarana_taipehensis	A
Hylarana_erythraea	A
Abavorana_luctuosa	A
Sanguirana_luzonensis	A
Sanguirana_igorota	A
Sanguirana_sanguinea	A
Glandirana_emeljanovi	A
Glandirana_rugosa	A
Glandirana_tientaiensis	A
Glandirana_minima	A
Pelophylax_caralitanus	A
Pelophylax_cerigensis	A
Pelophylax_bedriagae	A
Pelophylax_ridibundus	A
Pelophylax_kurtmuelleri	A
Pelophylax_cretensis	A
Pelophylax_epeiroticus	A
Pelophylax_bergeri	A
Pelophylax_lessonae	A
Pelophylax_shqipericus	A
Pelophylax_saharicus	A
Pelophylax_perezi	A
Pelophylax_plancyi	A
Pelophylax_chosenicus	A
Pelophylax_nigromaculatus	A
Pelophylax_hubeiensis	A
Pelophylax_fukienensis	A
Pelophylax_porosus	A
Amolops_akhaorum	A
Amolops_archotaphus	A
Amolops_daorum	A
Amolops_iriodes	A
Amolops_compotrix	S
Amolops_cucae	S
Amolops_vitreus	A
Amolops_chunganensis	A
Amolops_bellulus	A
Amolops_jinjiangensis	A
Amolops_tuberodepressus	A
Amolops_loloensis	A
Amolops_mantzorum	A
Amolops_lifanensis	A
Amolops_granulosus	A
Amolops_viridimaculatus	A
Amolops_indoburmanensis	A
Amolops_marmoratus	A
Amolops_panhai	S
Amolops_cremnobatus	S
Amolops_larutensis	-
Amolops_wuyiensis	A
Amolops_ricketti	A
Amolops_daiyunensis	S
Amolops_hongkongensis	S
Amolops_torrentis	S
Amolops_hainanensis	S
Amolops_spinapectoralis	A
Meristogenys_maryatiae	A
Meristogenys_orphnocnemis	A
Meristogenys_dyscritus	A
Meristogenys_whiteheadi	A
Meristogenys_stigmachilus	A
Meristogenys_poecilus	A
Meristogenys_stenocephalus	A
Meristogenys_amoropalamus	A
Meristogenys_phaeomerus	A
Meristogenys_jerboa	A
Meristogenys_kinabaluensis	A
Huia_sumatrana	A
Huia_masonii	A
Huia_melasma	A
Huia_cavitympanum	A
Clinotarsus_curtipes	A
Clinotarsus_alticola	A
Staurois_tuberilinguis	A
Staurois_parvus	A
Staurois_guttatus	A
Staurois_natator	A
Staurois_latopalmatus	A
Limnonectes_shompenorum	-
Limnonectes_macrodon	A
Limnonectes_paramacrodon	-
Limnonectes_finchi	S
Limnonectes_ingeri	A
Limnonectes_malesianus	A
Limnonectes_blythii	A
Limnonectes_poilani	S
Limnonectes_grunniens	A
Limnonectes_ibanorum	A
Limnonectes_leporinus	A
Limnonectes_woodworthi	A
Limnonectes_macrocephalus	-
Limnonectes_visayanus	S
Limnonectes_magnus	S
Limnonectes_modestus	S
Limnonectes_heinrichi	S
Limnonectes_microtympanum	-
Limnonectes_arathooni	S
Limnonectes_acanthi	S
Limnonectes_leytensis	S
Limnonectes_parvus	A
Limnonectes_palavanensis	S
Limnonectes_hascheanus	S
Limnonectes_limborgi	S
Limnonectes_plicatellus	S
Limnonectes_doriae	A
Limnonectes_kohchangae	S
Limnonectes_dabanus	S
Limnonectes_gyldenstolpei	-
Limnonectes_khasianus	-
Limnonectes_kadarsani	-
Limnonectes_microdiscus	S
Limnonectes_sisikdagu	-
Limnonectes_fujianensis	A
Limnonectes_namiyei	-
Limnonectes_bannaensis	A
Limnonectes_kuhlii	A
Limnonectes_jarujini	-
Limnonectes_taylori	-
Limnonectes_megastomias	-
Limnonectes_fragilis	-
Limnonectes_asperatus	A
Nanorana_arnoldi	A
Nanorana_chayuensis	A
Nanorana_maculosa	A
Nanorana_medogensis	A
Nanorana_conaensis	A
Nanorana_liebigii	A
Nanorana_ventripunctata	A
Nanorana_pleskei	A
Nanorana_parkeri	A
Nanorana_kangxianensis	A
Nanorana_taihangnica	A
Nanorana_quadranus	A
Nanorana_unculuanus	A
Nanorana_aenea	A
Nanorana_yunnanensis	A
Quasipaa_verrucospinosa	A
Quasipaa_boulengeri	A
Quasipaa_jiulongensis	A
Quasipaa_shini	A
Quasipaa_spinosa	A
Quasipaa_exilispinosa	A
Quasipaa_yei	A
Quasipaa_delacouri	A
Quasipaa_fasciculispina	A
Minervarya_pierrei	A
Minervarya_granosa	A
Minervarya_syhadrensis	A
Minervarya_caperata	A
Minervarya_sahyadris	A
Minervarya_greenii	A
Minervarya_kirtisinghei	A
Minervarya_kudremukhensis	A
Minervarya_rufescens	A
Minervarya_mudduraja	A
Minervarya_keralensis	A
Fejervarya_sakishimensis	A
Fejervarya_multistriata	A
Fejervarya_limnocharis	A
Fejervarya_iskandari	A
Fejervarya_orissaensis	A
Fejervarya_triora	A
Fejervarya_moodiei	A
Fejervarya_cancrivora	A
Fejervarya_vittigera	A
Sphaerotheca_dobsonii	A
Sphaerotheca_breviceps	A
Euphlyctis_mudigere	A
Euphlyctis_cyanophlyctis	A
Euphlyctis_ehrenbergii	A
Euphlyctis_aloysii	A
Euphlyctis_hexadactylus	A
Hoplobatrachus_tigerinus	A
Hoplobatrachus_rugulosus	A
Hoplobatrachus_crassus	A
Hoplobatrachus_occipitalis	A
Nannophrys_ceylonensis	S
Nannophrys_marmorata	S
Occidozyga_martensii	A
Occidozyga_magnapustulosa	A
Occidozyga_lima	A
Occidozyga_laevis	A
Occidozyga_baluensis	A
Ingerana_tenasserimensis	A
Ingerana_borealis	A
Indirana_brachytarsus	T
Indirana_beddomii	T
Indirana_semipalmata	T
Indirana_leithii	T
Walkerana_leptodactyla	T
Walkerana_diplosticta	T
Nyctibatrachus_grandis	S
Nyctibatrachus_sylvaticus	S
Nyctibatrachus_acanthodermis	S
Nyctibatrachus_gavi	S
Nyctibatrachus_major	S
Nyctibatrachus_indraneili	S
Nyctibatrachus_vrijeuni	S
Nyctibatrachus_shiradi	S
Nyctibatrachus_karnatakaensis	S
Nyctibatrachus_sanctipalustris	S
Nyctibatrachus_dattatreyaensis	S
Nyctibatrachus_kempholeyensis	S
Nyctibatrachus_petraeus	S
Nyctibatrachus_jog	S
Nyctibatrachus_humayuni	S
Nyctibatrachus_danieli	S
Nyctibatrachus_periyar	S
Nyctibatrachus_deveni	S
Nyctibatrachus_pillaii	S
Nyctibatrachus_aliciae	S
Nyctibatrachus_poocha	S
Nyctibatrachus_vasanthi	S
Nyctibatrachus_minor	S
Nyctibatrachus_deccanensis	S
Nyctibatrachus_anamallaiensis	S
Nyctibatrachus_beddomii	S
Nyctibatrachus_minimus	S
Lankanectes_corrugatus	-
Cornufer_punctatus	D
Cornufer_guppyi	D
Cornufer_vitiensis	D
Cornufer_guentheri	D
Cornufer_wuenscheorum	D
Cornufer_bimaculatus	D
Cornufer_vertebralis	D
Cornufer_cryptotis	D
Cornufer_pelewensis	D
Cornufer_papuensis	D
Cornufer_weberi	D
Platymantis_mimulus	D
Platymantis_naomii	D
Platymantis_dorsalis	D
Platymantis_corrugatus	D
Platymantis_hazelae	D
Platymantis_montanus	D
Alcalus_baluensis	D
Cacosternum_plimptoni	A
Cacosternum_striatum	A
Cacosternum_kinangopensis	A
Cacosternum_boettgeri	A
Cacosternum_aggestum	A
Cacosternum_leleupi	A
Cacosternum_australis	A
Cacosternum_rhythmum	A
Cacosternum_nanogularum	A
Cacosternum_parvum	A
Cacosternum_nanum	A
Cacosternum_capense	A
Cacosternum_namaquense	A
Cacosternum_karooicum	A
Microbatrachella_capensis	A
Cacosternum_platys	A
Poyntonia_paludicola	A
Arthroleptella_landdrosia	T
Arthroleptella_drewesii	T
Arthroleptella_subvoce	T
Arthroleptella_bicolor	T
Arthroleptella_villiersi	T
Arthroleptella_lightfooti	T
Arthroleptella_rugosa	T
Natalobatrachus_bonebergi	S
Amietia_vertebralis	A
Amietia_delalandii	A
Amietia_ruwenzorica	A
Amietia_poyntoni	A
Amietia_angolensis	A
Amietia_fuscigula	A
Amietia_vandijki	A
Strongylopus_fuelleborni	S
Strongylopus_bonaespei	S
Strongylopus_fasciatus	A
Strongylopus_wageri	S
Strongylopus_grayii	S
Anhydrophryne_rattrayi	T
Tomopterna_wambensis	A
Tomopterna_elegans	A
Tomopterna_kachowskii	A
Tomopterna_marmorata	A
Tomopterna_luganga	A
Tomopterna_krugerensis	A
Tomopterna_tuberculosa	A
Tomopterna_gallmanni	A
Tomopterna_delalandii	A
Tomopterna_damarensis	A
Tomopterna_cryptotis	A
Tomopterna_tandyi	A
Tomopterna_natalensis	A
Pyxicephalus_edulis	A
Pyxicephalus_adspersus	A
Aubria_subsigillata	A
Petropedetes_juliawurstnerae	S
Petropedetes_perreti	S
Petropedetes_euskircheni	S
Petropedetes_johnstoni	S
Petropedetes_vulpiae	S
Petropedetes_parkeri	S
Petropedetes_cameronensis	S
Petropedetes_palmipes	S
Arthroleptides_martiensseni	S
Arthroleptides_yakusini	S
Ericabatrachus_baleensis	S
Micrixalus_saxicola	A
Micrixalus_kottigeharensis	A
Micrixalus_fuscus	A
Conraua_robusta	A
Conraua_alleni	A
Conraua_crassipes	A
Conraua_goliath	A
Phrynobatrachus_werneri	A
Phrynobatrachus_schioetzi	A
Phrynobatrachus_manengoubensis	A
Phrynobatrachus_danko	A
Phrynobatrachus_batesii	A
Phrynobatrachus_steindachneri	A
Phrynobatrachus_cricogaster	A
Phrynobatrachus_ruthbeateae	A
Phrynobatrachus_chukuchuku	A
Phrynobatrachus_africanus	A
Phrynobatrachus_intermedius	A
Phrynobatrachus_liberiensis	A
Phrynobatrachus_tokba	T
Phrynobatrachus_acridoides	A
Phrynobatrachus_pakenhami	A
Phrynobatrachus_francisci	A
Phrynobatrachus_bullans	A
Phrynobatrachus_natalensis	A
Phrynobatrachus_plicatus	A
Phrynobatrachus_auritus	A
Phrynobatrachus_graueri	A
Phrynobatrachus_kinangopensis	A
Phrynobatrachus_latifrons	A
Phrynobatrachus_phyllophilus	S
Phrynobatrachus_alleni	A
Phrynobatrachus_ghanensis	A
Phrynobatrachus_guineensis	S
Phrynobatrachus_rainerguentheri	A
Phrynobatrachus_minutus	A
Phrynobatrachus_inexpectatus	A
Phrynobatrachus_scheffleri	A
Phrynobatrachus_rungwensis	A
Phrynobatrachus_uzungwensis	A
Phrynobatrachus_parvulus	A
Phrynobatrachus_keniensis	A
Phrynobatrachus_leveleve	A
Phrynobatrachus_dispar	A
Phrynobatrachus_gutturosus	A
Phrynobatrachus_fraterculus	A
Phrynobatrachus_maculiventris	A
Phrynobatrachus_pintoi	A
Phrynobatrachus_kakamikro	A
Phrynobatrachus_annulatus	A
Phrynobatrachus_calcaratus	A
Phrynobatrachus_villiersi	S
Phrynobatrachus_cornutus	A
Phrynobatrachus_mababiensis	A
Phrynobatrachus_ungujae	A
Phrynobatrachus_ukingensis	A
Phrynobatrachus_versicolor	A
Phrynobatrachus_petropedetoides	A
Phrynobatrachus_dendrobates	S
Phrynobatrachus_acutirostris	A
Phrynobatrachus_krefftii	S
Phrynobatrachus_sandersoni	T
Odontobatrachus_natator	S
Ptychadena_mahnerti	A
Ptychadena_uzungwensis	A
Ptychadena_porosissima	A
Ptychadena_perreti	A
Ptychadena_aequiplicata	A
Ptychadena_bibroni	A
Ptychadena_christyi	A
Ptychadena_erlangeri	A
Ptychadena_nana	A
Ptychadena_cooperi	A
Ptychadena_oxyrhynchus	A
Ptychadena_tellinii	A
Ptychadena_anchietae	A
Ptychadena_longirostris	A
Ptychadena_subpunctata	A
Ptychadena_newtoni	A
Ptychadena_nilotica	A
Ptychadena_mascareniensis	A
Ptychadena_taenioscelis	A
Ptychadena_pumilio	A
Hildebrandtia_ornata	A
Oreophryne_pseudasplenicola	D
Oreophryne_asplenicola	D
Oreophryne_anulata	D
Oreophryne_unicolor	D
Oreophryne_brachypus	D
Oreophryne_atrigularis	D
Oreophryne_wapoga	D
Oreophryne_sibilans	D
Oreophryne_clamata	D
Oreophryne_waira	D
Cophixalus_tridactylus	D
Cophixalus_humicola	D
Oreophryne_variabilis	D
Oreophryne_monticola	D
Paedophryne_swiftorum	D
Paedophryne_amauensis	D
Paedophryne_oyatabu	D
Barygenys_exsul	D
Cophixalus_balbus	D
Cophixalus_cheesmanae	D
Cophixalus_pakayakulangun	D
Cophixalus_kulakula	D
Cophixalus_infacetus	D
Cophixalus_ornatus	D
Aphantophryne_pansa	D
Cophixalus_cryptotympanum	D
Copiula_pipiens	D
Copiula_obsti	D
Copiula_derongo	D
Copiula_guttata	D
Barygenys_flavigularis	D
Cophixalus_sphagnicola	D
Austrochaperina_palmipes	D
Hylophorbus_proekes	D
Hylophorbus_tetraphonus	D
Hylophorbus_sextus	D
Hylophorbus_picoides	D
Hylophorbus_wondiwoi	D
Hylophorbus_richardsi	D
Hylophorbus_rufescens	D
Hylophorbus_nigrinus	D
Mantophryne_menziesi	D
Mantophryne_axanthogaster	D
Mantophryne_louisiadensis	D
Mantophryne_lateralis	D
Callulops_robustus	D
Callulops_omnistriatus	D
Callulops_doriae	D
Oninia_senglaubi	D
Asterophrys_marani	D
Asterophrys_slateri	D
Asterophrys_turpicola	D
Asterophrys_pullifer	D
Asterophrys_eurydactyla	D
Xenorhina_obesa	D
Xenorhina_lanthanites	D
Xenorhina_bouwensi	D
Xenorhina_varia	D
Xenorhina_oxycephala	D
Sphenophryne_dentata	D
Sphenophryne_cornuta	D
Sphenophryne_rhododactyla	D
Sphenophryne_crassa	D
Choerophryne_gracilirostris	D
Choerophryne_rostellifer	D
Choerophryne_proboscidea	D
Choerophryne_laurini	D
Sphenophryne_thomsoni	D
Sphenophryne_schlaginhaufeni	D
Copiula_oxyrhina	D
Copiula_major	D
Gastrophrynoides_immaculatus	-
Microhyla_malang	A
Microhyla_borneensis	A
Microhyla_mantheyi	A
Microhyla_achatina	A
Microhyla_okinavensis	A
Microhyla_mixtura	A
Microhyla_fissipes	A
Microhyla_ornata	A
Microhyla_heymonsi	A
Microhyla_pulchra	A
Microhyla_berdmorei	A
Microhyla_rubra	A
Microhyla_butleri	A
Microhyla_palmipes	A
Microhyla_superciliaris	A
Microhyla_marmorata	A
Microhyla_annectens	A
Microhyla_petrigena	A
Microhyla_perparva	A
Glyphoglossus_guttulatus	A
Glyphoglossus_minutus	A
Glyphoglossus_molossus	A
Glyphoglossus_yunnanensis	A
Micryletta_steinegeri	A
Micryletta_inornata	A
Chaperina_fusca	A
Kaloula_walteri	A
Kaloula_rigida	A
Kaloula_conjuncta	A
Kaloula_kokacii	A
Kaloula_kalingensis	A
Kaloula_picta	A
Kaloula_baleata	A
Kaloula_mediolineata	A
Kaloula_pulchra	A
Kaloula_verrucosa	A
Kaloula_rugifera	A
Kaloula_borealis	A
Uperodon_obscurus	A
Uperodon_montanus	A
Uperodon_variegatus	A
Uperodon_systoma	A
Uperodon_taprobanicus	A
Metaphrynella_sundana	A
Metaphrynella_pollicaris	A
Phrynella_pulchra	A
Dyscophus_guineti	A
Dyscophus_antongilii	A
Dyscophus_insularis	A
Kalophrynus_subterrestris	A
Kalophrynus_intermedius	A
Kalophrynus_baluensis	A
Kalophrynus_heterochirus	A
Kalophrynus_palmatissimus	A
Kalophrynus_interlineatus	A
Kalophrynus_yongi	A
Kalophrynus_pleurostigma	A
Otophryne_robusta	S
Otophryne_pyburni	S
Otophryne_steyermarki	S
Synapturanus_salseri	T
Synapturanus_mirandaribeiroi	T
Melanobatrachus_indicus	A
Anilany_helenae	S
Rhombophryne_minuta	S
Cophyla_phyllodactyla	S
Cophyla_berara	S
Plethodontohyla_guentheri	A
Plethodontohyla_fonetana	S
Plethodontohyla_notosticta	A
Plethodontohyla_bipunctata	A
Plethodontohyla_tuberata	S
Plethodontohyla_ocellata	A
Plethodontohyla_brevipes	A
Plethodontohyla_mihanika	A
Plethodontohyla_inguinalis	A
Cophyla_pollicaris	S
Cophyla_barbouri	S
Cophyla_mavomavo	S
Cophyla_tetra	S
Cophyla_tuberifera	S
Cophyla_milloti	S
Cophyla_alticola	S
Cophyla_tsaratananaensis	S
Cophyla_grandis	S
Anodonthyla_theoi	A
Anodonthyla_pollicaris	A
Anodonthyla_nigrigularis	A
Anodonthyla_moramora	A
Anodonthyla_vallani	A
Anodonthyla_boulengerii	A
Anodonthyla_hutchisoni	A
Anodonthyla_jeanbai	A
Anodonthyla_rouxae	A
Anodonthyla_montana	A
Anodonthyla_emilei	A
Stumpffia_megsoni	T
Stumpffia_hara	T
Stumpffia_be	T
Stumpffia_staffordi	T
Stumpffia_madagascariensis	T
Stumpffia_pygmaea	T
Stumpffia_gimmeli	T
Stumpffia_psologlossa	T
Stumpffia_roseifemoralis	T
Stumpffia_grandis	T
Stumpffia_tetradactyla	T
Stumpffia_tridactyla	T
Rhombophryne_coronata	S
Rhombophryne_serratopalpebrosa	S
Plethodontohyla_alluaudi	S
Rhombophryne_laevipes	S
Rhombophryne_testudo	S
Rhombophryne_coudreaui	S
Scaphiophryne_menabensis	A
Scaphiophryne_madagascariensis	A
Scaphiophryne_boribory	A
Scaphiophryne_marmorata	A
Scaphiophryne_gottlebei	A
Scaphiophryne_spinosa	A
Scaphiophryne_calcarata	A
Scaphiophryne_brevis	A
Paradoxophyla_palmata	A
Paradoxophyla_tiarano	A
Hypopachus_ustus	A
Hypopachus_barberi	A
Hypopachus_variolosus	A
Hypopachus_pictiventris	A
Gastrophryne_carolinensis	A
Gastrophryne_olivacea	A
Gastrophryne_elegans	A
Elachistocleis_ovalis	A
Elachistocleis_cesarii	A
Elachistocleis_surinamensis	A
Elachistocleis_bicolor	A
Dermatonotus_muelleri	A
Arcovomer_passarellii	A
Hamptophryne_boliviana	A
Stereocyclops_incrassatus	A
Dasypops_schirchi	A
Myersiella_microps	T
Chiasmocleis_alagoana	A
Chiasmocleis_cordeiroi	A
Chiasmocleis_crucis	A
Chiasmocleis_schubarti	A
Chiasmocleis_carvalhoi	A
Chiasmocleis_capixaba	A
Chiasmocleis_mantiqueira	A
Chiasmocleis_leucosticta	A
Chiasmocleis_albopunctata	A
Chiasmocleis_devriesi	A
Chiasmocleis_ventrimaculata	A
Chiasmocleis_anatipes	A
Chiasmocleis_shudikarensis	A
Chiasmocleis_avilapiresae	A
Chiasmocleis_antenori	A
Chiasmocleis_bassleri	A
Chiasmocleis_hudsoni	A
Ctenophryne_aequatorialis	A
Ctenophryne_geayi	A
Hoplophryne_rogersi	S
Hoplophryne_uluguruensis	S
Phrynomantis_microps	A
Phrynomantis_bifasciatus	A
Phrynomantis_annectens	A
Hyperolius_thomensis	S
Hyperolius_molleri	S
Hyperolius_veithi	S
Hyperolius_cinnamomeoventris	S
Hyperolius_concolor	S
Hyperolius_zonatus	S
Hyperolius_substriatus	S
Hyperolius_puncticulatus	A
Hyperolius_mitchelli	S
Hyperolius_montanus	S
Hyperolius_tanneri	-
Hyperolius_spinigularis	S
Hyperolius_minutissimus	-
Hyperolius_bobirensis	S
Hyperolius_picturatus	S
Hyperolius_baumanni	S
Hyperolius_sylvaticus	S
Hyperolius_chlorosteus	S
Hyperolius_laurenti	-
Hyperolius_torrentis	S
Hyperolius_frontalis	S
Hyperolius_castaneus	S
Hyperolius_cystocandicans	S
Hyperolius_jackie	-
Hyperolius_discodactylus	-
Hyperolius_lateralis	S
Hyperolius_chelaensis	-
Hyperolius_cinereus	-
Hyperolius_mosaicus	S
Hyperolius_ocellatus	S
Hyperolius_quinquevittatus	-
Hyperolius_kivuensis	S
Hyperolius_tuberilinguis	S
Alexteroon_obstetricans	S
Hyperolius_tuberculatus	A
Hyperolius_nitidulus	A
Hyperolius_parallelus	A
Hyperolius_spatzi	-
Hyperolius_phantasticus	S
Hyperolius_glandicolor	S
Hyperolius_marmoratus	A
Hyperolius_viridiflavus	A
Hyperolius_lamottei	S
Hyperolius_argus	S
Hyperolius_fusciventris	S
Hyperolius_guttulatus	S
Hyperolius_pardalis	S
Hyperolius_riggenbachi	S
Hyperolius_howelli	A
Hyperolius_microps	A
Hyperolius_friedemanni	A
Hyperolius_adspersus	A
Hyperolius_dartevellei	A
Hyperolius_igbettensis	A
Hyperolius_jacobseni	A
Hyperolius_poweri	-
Hyperolius_rwandae	-
Hyperolius_benguellensis	A
Hyperolius_nasutus	A
Hyperolius_inyangae	A
Hyperolius_viridis	-
Hyperolius_pusillus	S
Hyperolius_lupiroensis	S
Hyperolius_horstockii	S
Hyperolius_semidiscus	S
Morerella_cyanophthalma	S
Heterixalus_rutenbergi	S
Heterixalus_luteostriatus	S
Heterixalus_carbonei	S
Heterixalus_betsileo	S
Heterixalus_variabilis	S
Heterixalus_tricolor	S
Heterixalus_andrakata	S
Heterixalus_boettgeri	S
Heterixalus_alboguttatus	S
Heterixalus_madagascariensis	S
Heterixalus_punctatus	S
Tachycnemis_seychellensis	S
Afrixalus_dorsalis	S
Afrixalus_paradorsalis	S
Afrixalus_quadrivittatus	S
Afrixalus_laevis	S
Afrixalus_fornasini	S
Afrixalus_stuhlmanni	S
Afrixalus_delicatus	S
Afrixalus_knysnae	S
Opisthothylax_immaculatus	S
Kassina_senegalensis	A
Kassina_maculosa	A
Semnodactylus_wealii	A
Phlyctimantis_verrucosus	A
Phlyctimantis_maculatus	A
Phlyctimantis_leonardi	A
Acanthixalus_spinosus	S
Acanthixalus_sonjae	S
Cryptothylax_greshoffii	S
Arthroleptis_bioko	D
Arthroleptis_brevipes	D
Arthroleptis_adelphus	D
Arthroleptis_poecilonotus	D
Arthroleptis_nimbaensis	D
Arthroleptis_crusculum	D
Arthroleptis_langeri	D
Arthroleptis_palava	D
Arthroleptis_krokosua	D
Arthroleptis_variabilis	D
Arthroleptis_perreti	D
Arthroleptis_adolfifriederici	D
Arthroleptis_tanneri	D
Arthroleptis_stenodactylus	D
Arthroleptis_nikeae	D
Arthroleptis_affinis	D
Arthroleptis_reichei	D
Arthroleptis_wahlbergii	D
Arthroleptis_francei	D
Arthroleptis_formosus	D
Arthroleptis_aureoli	D
Arthroleptis_sylvaticus	D
Arthroleptis_taeniatus	D
Arthroleptis_xenodactyloides	D
Arthroleptis_schubotzi	D
Arthroleptis_xenodactylus	D
Arthroleptis_kidogo	D
Arthroleptis_fichika	D
Cardioglossa_manengouba	S
Cardioglossa_oreas	S
Cardioglossa_pulchra	S
Cardioglossa_occidentalis	S
Cardioglossa_leucomystax	S
Cardioglossa_elegans	S
Cardioglossa_gratiosa	S
Cardioglossa_melanogaster	S
Cardioglossa_schioetzi	S
Cardioglossa_gracilis	S
Leptopelis_fiziensis	S
Leptopelis_karissimbensis	S
Leptopelis_millsoni	S
Leptopelis_kivuensis	S
Leptopelis_bocagii	S
Leptopelis_concolor	S
Leptopelis_vermiculatus	S
Leptopelis_modestus	S
Leptopelis_brevirostris	S
Leptopelis_palmatus	S
Leptopelis_calcaratus	S
Leptopelis_natalensis	S
Leptopelis_argenteus	S
Leptopelis_flavomaculatus	S
Astylosternus_schioetzi	A
Astylosternus_batesi	A
Astylosternus_diadematus	A
Trichobatrachus_robustus	A
Astylosternus_occidentalis	A
Astylosternus_laticephalus	A
Scotobleps_gabonicus	A
Nyctibates_corrugatus	A
Leptodactylodon_perreti	A
Leptodactylodon_axillaris	A
Leptodactylodon_bicolor	A
Callulina_shengena	T
Callulina_laphami	T
Callulina_kanga	T
Callulina_dawida	T
Callulina_kreffti	T
Callulina_kisiwamsitu	T
Callulina_stanleyi	T
Spelaeophryne_methneri	T
Probreviceps_loveridgei	T
Probreviceps_macrodactylus	T
Probreviceps_uluguruensis	T
Probreviceps_rungwensis	T
Probreviceps_durirostris	T
Balebreviceps_hillmani	T
Breviceps_namaquensis	T
Breviceps_macrops	T
Breviceps_branchi	T
Breviceps_fuscus	T
Breviceps_mossambicus	T
Breviceps_fichus	T
Breviceps_adspersus	T
Hemisus_marmoratus	S
Sechellophryne_gardineri	D
Sechellophryne_pipilodryas	D
Sooglossus_sechellensis	T
Sooglossus_thomasseti	T
Nasikabatrachus_sahyadrensis	A
Heleophryne_regis	A
Heleophryne_purcelli	A
Hadromophryne_natalensis	A
Leptobrachium_guangxiense	A
Leptobrachium_hainanense	A
Leptobrachium_buchardi	A
Leptobrachium_ngoclinhense	A
Leptobrachium_pullum	A
Leptobrachium_mouhoti	A
Leptobrachium_xanthops	A
Leptobrachium_xanthospilum	A
Leptobrachium_leucops	A
Leptobrachium_banae	A
Leptobrachium_leishanense	A
Leptobrachium_liui	A
Leptobrachium_boringii	A
Leptobrachium_ailaonicum	A
Leptobrachium_chapaense	A
Leptobrachium_huashen	A
Leptobrachium_promustache	A
Leptobrachium_nigrops	A
Leptobrachium_kanowitense	A
Leptobrachium_ingeri	A
Leptobrachium_hendricksoni	A
Leptobrachium_hasseltii	A
Leptobrachium_smithi	A
Leptobrachium_rakhinense	A
Leptobrachium_abbotti	A
Leptobrachium_waysepuntiense	A
Leptobrachium_gunungense	A
Leptobrachium_montanum	A
Leptobrachium_lumadorum	A
Leptobrachium_mangyanorum	A
Leptobrachium_tagbanorum	A
Oreolalax_popei	A
Oreolalax_omeimontis	A
Oreolalax_chuanbeiensis	A
Oreolalax_nanjiangensis	A
Oreolalax_multipunctatus	A
Oreolalax_major	A
Oreolalax_liangbeiensis	A
Oreolalax_rugosus	A
Oreolalax_xiangchengensis	A
Oreolalax_jingdongensis	A
Oreolalax_pingii	A
Oreolalax_schmidti	A
Oreolalax_lichuanensis	A
Oreolalax_rhodostigmatus	A
Scutiger_tuberculatus	A
Scutiger_muliensis	A
Scutiger_boulengeri	A
Scutiger_mammatus	A
Scutiger_liupanensis	A
Scutiger_glandulatus	A
Scutiger_chintingensis	A
Scutiger_ningshanensis	A
Leptobrachella_pelodytoides	A
Leptobrachella_ventripunctata	A
Leptobrachella_bourreti	A
Leptobrachella_aerea	A
Leptobrachella_minima	A
Leptobrachella_pluvialis	A
Leptobrachella_eos	A
Leptobrachella_oshanensis	A
Leptobrachella_liui	A
Leptobrachella_firthi	A
Leptobrachella_bidoupensis	A
Leptobrachella_applebyi	A
Leptobrachella_melica	A
Leptobrachella_heteropus	A
Leptobrachella_sabahmontana	A
Leptobrachella_dringi	A
Leptobrachella_fritinniens	A
Leptobrachella_picta	A
Leptobrachella_maura	A
Leptobrachella_arayai	A
Leptobrachella_gracilis	A
Megophrys_omeimontis	A
Megophrys_spinata	A
Megophrys_parva	A
Megophrys_jinggangensis	A
Megophrys_huangshanensis	A
Megophrys_brachykolos	A
Megophrys_kuatunensis	A
Megophrys_boettgeri	A
Megophrys_minor	A
Megophrys_microstoma	A
Megophrys_hansi	A
Megophrys_mangshanensis	A
Megophrys_major	A
Megophrys_lekaguli	A
Megophrys_longipes	A
Megophrys_aceras	A
Megophrys_intermedia	A
Megophrys_carinense	A
Megophrys_feae	A
Megophrys_nankiangensis	A
Megophrys_shapingensis	A
Megophrys_baluensis	A
Megophrys_nasuta	A
Pelobates_varaldii	A
Pelobates_cultripes	A
Pelobates_syriacus	A
Pelobates_fuscus	A
Pelodytes_punctatus	A
Pelodytes_ibericus	A
Pelodytes_caucasicus	A
Spea_intermontana	A
Spea_bombifrons	A
Spea_hammondii	A
Spea_multiplicata	A
Scaphiopus_holbrookii	A
Scaphiopus_hurterii	A
Scaphiopus_couchii	A
Xenopus_longipes	A
Xenopus_amieti	A
Xenopus_boumbaensis	A
Xenopus_itombwensis	A
Xenopus_wittei	A
Xenopus_andrei	A
Xenopus_pygmaeus	A
Xenopus_fraseri	A
Xenopus_victorianus	A
Xenopus_petersii	A
Xenopus_laevis	A
Xenopus_gilli	A
Xenopus_vestitus	A
Xenopus_lenduensis	A
Xenopus_clivii	A
Xenopus_borealis	A
Xenopus_ruwenzoriensis	A
Xenopus_largeni	A
Xenopus_muelleri	A
Xenopus_tropicalis	A
Xenopus_epitropicalis	A
Pseudhymenochirus_merlini	A
Hymenochirus_boettgeri	A
Pipa_pipa	D
Pipa_parva	S
Pipa_carvalhoi	S
Rhinophrynus_dorsalis	A
Discoglossus_pictus	A
Discoglossus_sardus	A
Discoglossus_scovazzi	A
Discoglossus_galganoi	A
Discoglossus_montalentii	A
Latonia_nigriventer	A
Alytes_dickhilleni	S
Alytes_muletensis	S
Alytes_maurus	S
Alytes_obstetricans	S
Alytes_cisternasii	S
Bombina_variegata	A
Bombina_pachypus	A
Bombina_bombina	A
Bombina_orientalis	A
Bombina_microdeladigitora	A
Bombina_maxima	A
Barbourula_busuangensis	-
Barbourula_kalimantanensis	-
Leiopelma_hamiltoni	T
Leiopelma_pakeka	T
Leiopelma_archeyi	T
Leiopelma_hochstetteri	S
Ascaphus_truei	A
Ascaphus_montanus	A
