Bolitoglossa_altamazonica	D
Bolitoglossa_peruviana	D
Bolitoglossa_palmata	D
Bolitoglossa_equatoriana	D
Bolitoglossa_paraensis	D
Bolitoglossa_adspersa	D
Bolitoglossa_medemi	D
Bolitoglossa_sima	D
Bolitoglossa_biseriata	D
Bolitoglossa_tamaense	D
Bolitoglossa_orestes	D
Bolitoglossa_mucuyensis	D
Bolitoglossa_nicefori	D
Bolitoglossa_leandrae	D
Bolitoglossa_compacta	D
Bolitoglossa_robusta	D
Bolitoglossa_schizodactyla	D
Bolitoglossa_colonnea	D
Bolitoglossa_nigrescens	D
Bolitoglossa_jugivagans	D
Bolitoglossa_aureogularis	D
Bolitoglossa_robinsoni	D
Bolitoglossa_subpalmata	D
Bolitoglossa_tica	D
Bolitoglossa_gracilis	D
Bolitoglossa_splendida	D
Bolitoglossa_pesrubra	D
Bolitoglossa_bramei	D
Bolitoglossa_kamuk	D
Bolitoglossa_gomezi	D
Bolitoglossa_epimela	D
Bolitoglossa_cerroensis	D
Bolitoglossa_marmorea	D
Bolitoglossa_minutula	D
Bolitoglossa_sooyorum	D
Bolitoglossa_mombachoensis	D
Bolitoglossa_striatula	D
Bolitoglossa_mulleri	D
Bolitoglossa_yucatana	D
Bolitoglossa_lignicolor	D
Bolitoglossa_odonnelli	D
Bolitoglossa_mexicana	D
Bolitoglossa_platydactyla	D
Bolitoglossa_flaviventris	D
Bolitoglossa_nympha	D
Bolitoglossa_rufescens	D
Bolitoglossa_chinanteca	D
Bolitoglossa_occidentalis	D
Bolitoglossa_stuarti	D
Bolitoglossa_xibalba	D
Bolitoglossa_hartwegi	D
Bolitoglossa_eremia	D
Bolitoglossa_suchitanensis	D
Bolitoglossa_daryorum	D
Bolitoglossa_kaqchikelorum	D
Bolitoglossa_morio	D
Bolitoglossa_flavimembris	D
Bolitoglossa_dunni	D
Bolitoglossa_diaphora	D
Bolitoglossa_conanti	D
Bolitoglossa_carri	D
Bolitoglossa_oresbia	D
Bolitoglossa_meliana	D
Bolitoglossa_celaque	D
Bolitoglossa_synoria	D
Bolitoglossa_heiroreias	D
Bolitoglossa_porrasorum	D
Bolitoglossa_longissima	D
Bolitoglossa_decora	D
Bolitoglossa_franklini	D
Bolitoglossa_lincolni	D
Bolitoglossa_dofleini	D
Bolitoglossa_alvaradoi	D
Bolitoglossa_huehuetenanguensis	D
Bolitoglossa_ninadormida	D
Bolitoglossa_centenorum	D
Bolitoglossa_nussbaumi	D
Bolitoglossa_cuchumatana	D
Bolitoglossa_helmrichi	D
Bolitoglossa_rostrata	D
Bolitoglossa_zacapensis	D
Bolitoglossa_engelhardti	D
Bolitoglossa_hermosa	D
Bolitoglossa_riletti	D
Bolitoglossa_zapoteca	D
Bolitoglossa_macrinii	D
Bolitoglossa_oaxacensis	D
Pseudoeurycea_obesa	D
Pseudoeurycea_mystax	D
Pseudoeurycea_werleri	D
Pseudoeurycea_conanti	D
Pseudoeurycea_orchileucos	D
Pseudoeurycea_leprosa	D
Pseudoeurycea_firscheini	D
Pseudoeurycea_nigromaculata	D
Pseudoeurycea_lynchi	D
Pseudoeurycea_lineola	D
Pseudoeurycea_juarezi	D
Pseudoeurycea_saltator	D
Pseudoeurycea_aurantia	D
Pseudoeurycea_unguidentis	D
Pseudoeurycea_ruficauda	D
Pseudoeurycea_cochranae	D
Pseudoeurycea_anitae	D
Pseudoeurycea_gadovii	D
Pseudoeurycea_melanomolga	D
Pseudoeurycea_robertsi	D
Pseudoeurycea_altamontana	D
Pseudoeurycea_longicauda	D
Pseudoeurycea_tenchalli	D
Pseudoeurycea_papenfussi	D
Pseudoeurycea_smithi	D
Pseudoeurycea_rex	D
Pseudoeurycea_goebeli	D
Pseudoeurycea_brunnata	D
Pseudoeurycea_exspectata	D
Aquiloeurycea_quetzalanensis	D
Aquiloeurycea_cephalica	D
Aquiloeurycea_cafetalera	D
Aquiloeurycea_galeanae	D
Aquiloeurycea_scandens	D
Isthmura_naucampatepetl	D
Isthmura_gigantea	D
Isthmura_bellii	D
Isthmura_maxima	D
Isthmura_boneti	D
Ixalotriton_niger	D
Ixalotriton_parvus	D
Parvimolge_townsendi	D
Oedipina_pacificensis	D
Oedipina_uniformis	D
Oedipina_gracilis	D
Oedipina_collaris	D
Oedipina_grandis	D
Oedipina_poelzi	D
Oedipina_pseudouniformis	D
Oedipina_cyclocauda	D
Oedipina_koehleri	D
Oedipina_leptopoda	D
Oedipina_stenopodia	D
Oedipina_taylori	D
Oedipina_maritima	D
Oedipina_complex	D
Oedipina_parvipes	D
Oedipina_savagei	D
Oedipina_alleni	D
Oedipina_carablanca	D
Oedipina_elongata	D
Oedipina_gephyra	D
Oedipina_tomasi	D
Oedipina_nica	D
Oedipina_kasios	D
Oedipina_quadra	D
Bradytriton_silus	D
Nototriton_barbouri	D
Nototriton_brodiei	D
Nototriton_stuarti	D
Nototriton_picucha	D
Nototriton_limnospectator	D
Nototriton_lignicola	D
Nototriton_tomamorum	D
Nototriton_richardi	D
Nototriton_picadoi	D
Nototriton_matama	D
Nototriton_abscondens	D
Nototriton_gamezi	D
Nototriton_guanacaste	D
Nototriton_saslaya	D
Dendrotriton_megarhinus	D
Dendrotriton_xolocalcae	D
Dendrotriton_bromeliacius	D
Dendrotriton_sanctibarbarus	D
Dendrotriton_rabbi	D
Dendrotriton_kekchiorum	D
Dendrotriton_cuchumatanus	D
Dendrotriton_chujorum	D
Nyctanolis_pernix	D
Thorius_omiltemi	D
Thorius_grandis	D
Thorius_pulmonaris	D
Thorius_aureus	D
Thorius_boreas	D
Thorius_narisovalis	D
Thorius_minutissimus	D
Thorius_papaloae	D
Thorius_arboreus	D
Thorius_macdougalli	D
Thorius_spilogaster	D
Thorius_minydemus	D
Thorius_insperatus	D
Thorius_pennatulus	D
Thorius_smithi	D
Thorius_troglodytes	D
Thorius_dubitus	D
Thorius_magnipes	D
Thorius_schmidti	D
Thorius_lunaris	D
Thorius_munificus	D
Chiropterotriton_multidentatus	D
Chiropterotriton_cracens	D
Chiropterotriton_arboreus	D
Chiropterotriton_terrestris	D
Chiropterotriton_priscus	D
Chiropterotriton_magnipes	D
Chiropterotriton_chondrostega	D
Chiropterotriton_orculus	D
Chiropterotriton_dimidiatus	D
Chiropterotriton_lavae	D
Cryptotriton_sierraminensis	D
Cryptotriton_veraepacis	D
Cryptotriton_nasalis	D
Cryptotriton_alvarezdeltoroi	D
Batrachoseps_gregarius	D
Batrachoseps_bramei	D
Batrachoseps_stebbinsi	D
Batrachoseps_nigriventris	D
Batrachoseps_simatus	D
Batrachoseps_relictus	D
Batrachoseps_kawia	D
Batrachoseps_diabolicus	D
Batrachoseps_regius	D
Batrachoseps_minor	D
Batrachoseps_incognitus	D
Batrachoseps_major	D
Batrachoseps_pacificus	D
Batrachoseps_gavilanensis	D
Batrachoseps_luciae	D
Batrachoseps_gabrieli	D
Batrachoseps_attenuatus	D
Batrachoseps_campi	D
Batrachoseps_wrighti	D
Eurycea_pterophila	P
Eurycea_neotenes	P
Eurycea_sosorum	P
Eurycea_nana	P
Eurycea_latitans	P
Eurycea_troglodytes	P
Eurycea_waterlooensis	P
Eurycea_rathbuni	P
Eurycea_chisholmensis	P
Eurycea_tonkawae	P
Eurycea_naufragia	P
Eurycea_quadridigitata	A
Eurycea_chamberlaini	A
Eurycea_aquatica	A
Eurycea_junaluska	A
Eurycea_wallacei	P
Eurycea_wilderae	A
Eurycea_cirrigera	A
Eurycea_bislineata	A
Eurycea_longicauda	A
Eurycea_guttolineata	A
Eurycea_lucifuga	A
Eurycea_spelaea	A
Eurycea_tynerensis	P
Eurycea_multiplicata	A
Urspelerpes_brucei	A
Gyrinophilus_palleucus	P
Gyrinophilus_gulolineatus	P
Gyrinophilus_subterraneus	A
Gyrinophilus_porphyriticus	A
Pseudotriton_ruber	A
Pseudotriton_montanus	A
Stereochilus_marginatus	A
Hemidactylium_scutatum	S
Plethodon_variolatus	D
Plethodon_chlorobryonis	D
Plethodon_teyahalee	D
Plethodon_cylindraceus	D
Plethodon_glutinosus	D
Plethodon_aureolus	D
Plethodon_cheoah	D
Plethodon_chattahoochee	D
Plethodon_meridianus	D
Plethodon_amplus	D
Plethodon_montanus	D
Plethodon_metcalfi	D
Plethodon_shermani	D
Plethodon_savannah	D
Plethodon_ocmulgee	D
Plethodon_grobmani	D
Plethodon_mississippi	D
Plethodon_kisatchie	D
Plethodon_albagula	D
Plethodon_sequoyah	D
Plethodon_kiamichi	D
Plethodon_jordani	D
Plethodon_ouachitae	D
Plethodon_fourchensis	D
Plethodon_caddoensis	D
Plethodon_kentucki	D
Plethodon_petraeus	D
Plethodon_yonahlossee	D
Plethodon_dorsalis	D
Plethodon_ventralis	D
Plethodon_angusticlavius	D
Plethodon_welleri	D
Plethodon_punctatus	D
Plethodon_wehrlei	D
Plethodon_websteri	D
Plethodon_richmondi	D
Plethodon_electromorphus	D
Plethodon_hubrichti	D
Plethodon_nettingi	D
Plethodon_shenandoah	D
Plethodon_cinereus	D
Plethodon_virginia	D
Plethodon_hoffmani	D
Plethodon_sherando	D
Plethodon_serratus	D
Plethodon_stormi	D
Plethodon_elongatus	D
Plethodon_asupak	D
Plethodon_vehiculum	D
Plethodon_dunni	D
Plethodon_vandykei	D
Plethodon_idahoensis	D
Plethodon_larselli	D
Plethodon_neomexicanus	D
Desmognathus_auriculatus	S
Desmognathus_conanti	S
Desmognathus_santeetlah	S
Desmognathus_brimleyorum	S
Desmognathus_apalachicolae	S
Desmognathus_monticola	S
Desmognathus_carolinensis	S
Desmognathus_ocoee	S
Desmognathus_ochrophaeus	S
Desmognathus_orestes	S
Desmognathus_fuscus	S
Desmognathus_planiceps	S
Desmognathus_welteri	S
Desmognathus_imitator	S
Desmognathus_aeneus	D
Desmognathus_folkertsi	S
Desmognathus_quadramaculatus	A
Desmognathus_marmoratus	A
Desmognathus_wrighti	D
Phaeognathus_hubrichti	D
Aneides_vagrans	D
Aneides_ferreus	D
Aneides_flavipunctatus	D
Aneides_lugubris	D
Aneides_hardii	D
Aneides_aeneus	D
Ensatina_eschscholtzii	D
Speleomantes_sarrabusensis	D
Speleomantes_imperialis	D
Speleomantes_supramontis	D
Speleomantes_flavus	D
Speleomantes_genei	D
Speleomantes_italicus	D
Speleomantes_ambrosii	D
Speleomantes_strinatii	D
Hydromantes_platycephalus	D
Hydromantes_brunus	D
Hydromantes_shastae	D
Karsenia_koreana	D
Amphiuma_means	P
Amphiuma_pholeter	P
Amphiuma_tridactylum	P
Rhyacotriton_cascadae	A
Rhyacotriton_kezeri	A
Rhyacotriton_variegatus	A
Rhyacotriton_olympicus	A
Necturus_alabamensis	P
Necturus_beyeri	P
Necturus_maculosus	P
Necturus_lewisi	P
Necturus_punctatus	P
Proteus_anguinus	P
Paramesotriton_yunwuensis	A
Paramesotriton_guangxiensis	A
Paramesotriton_fuzhongensis	A
Paramesotriton_deloustali	A
Paramesotriton_hongkongensis	A
Paramesotriton_labiatus	A
Paramesotriton_chinensis	A
Paramesotriton_maolanensis	A
Paramesotriton_longliensis	A
Paramesotriton_zhijinensis	A
Paramesotriton_wulingensis	A
Paramesotriton_caudopunctatus	A
Pachytriton_granulosus	A
Pachytriton_brevipes	A
Pachytriton_feii	A
Pachytriton_archospotus	A
Pachytriton_moi	A
Pachytriton_inexpectatus	A
Laotriton_laoensis	A
Cynops_fudingensis	A
Cynops_orientalis	A
Cynops_orphicus	A
Cynops_cyanurus	A
Cynops_glaucus	A
Cynops_pyrrhogaster	A
Cynops_ensicauda	A
Triturus_cristatus	A
Triturus_dobrogicus	A
Triturus_karelinii	A
Triturus_macedonicus	A
Triturus_carnifex	A
Triturus_marmoratus	A
Triturus_pygmaeus	A
Calotriton_asper	A
Calotriton_arnoldi	A
Neurergus_crocatus	A
Neurergus_kaiseri	A
Neurergus_strauchii	A
Ommatotriton_vittatus	A
Ommatotriton_ophryticus	A
Lissotriton_vulgaris	A
Lissotriton_montandoni	A
Lissotriton_italicus	A
Lissotriton_helveticus	A
Lissotriton_boscai	A
Ichthyosaura_alpestris	A
Euproctus_platycephalus	A
Euproctus_montanus	A
Taricha_torosa	A
Taricha_granulosa	A
Taricha_rivularis	A
Notophthalmus_viridescens	A
Notophthalmus_perstriatus	A
Notophthalmus_meridionalis	A
Tylototriton_notialis	S
Tylototriton_asperrimus	S
Tylototriton_ziegleri	S
Tylototriton_hainanensis	S
Tylototriton_lizhengchangi	S
Tylototriton_wenxianensis	A
Tylototriton_vietnamensis	A
Tylototriton_panhai	S
Tylototriton_uyenoi	S
Tylototriton_yangi	A
Tylototriton_shanjing	A
Tylototriton_verrucosus	A
Tylototriton_kweichowensis	A
Tylototriton_taliangensis	A
Echinotriton_chinhaiensis	S
Echinotriton_andersoni	S
Pleurodeles_poireti	A
Pleurodeles_nebulosus	A
Pleurodeles_waltl	A
Salamandrina_terdigitata	A
Salamandrina_perspicillata	A
Lyciasalamandra_helverseni	V
Lyciasalamandra_antalyana	V
Lyciasalamandra_billae	V
Lyciasalamandra_fazilae	V
Lyciasalamandra_flavimembris	V
Lyciasalamandra_atifi	V
Lyciasalamandra_luschani	V
Salamandra_infraimmaculata	V
Salamandra_salamandra	V
Salamandra_algira	V
Salamandra_corsica	V
Salamandra_lanzai	V
Salamandra_atra	V
Chioglossa_lusitanica	A
Mertensiella_caucasica	A
Ambystoma_andersoni	P
Ambystoma_mexicanum	P
Ambystoma_rosaceum	A
Ambystoma_dumerilii	A
Ambystoma_ordinarium	A
Ambystoma_tigrinum	A
Ambystoma_californiense	A
Ambystoma_cingulatum	S
Ambystoma_bishopi	S
Ambystoma_annulatum	A
Ambystoma_barbouri	A
Ambystoma_texanum	A
Ambystoma_mabeei	A
Ambystoma_macrodactylum	A
Ambystoma_laterale	A
Ambystoma_jeffersonianum	A
Ambystoma_opacum	S
Ambystoma_maculatum	A
Ambystoma_gracile	A
Ambystoma_talpoideum	A
Dicamptodon_copei	P
Dicamptodon_aterrimus	A
Dicamptodon_ensatus	A
Dicamptodon_tenebrosus	A
Pseudobranchus_axanthus	P
Pseudobranchus_striatus	P
Siren_lacertina	P
Siren_intermedia	P
Hynobius_guabangshanensis	A
Hynobius_maoershanensis	A
Hynobius_chinensis	A
Hynobius_yiwuensis	A
Hynobius_amjiensis	A
Hynobius_naevius	A
Hynobius_katoi	A
Hynobius_hidamontanus	A
Hynobius_dunni	A
Hynobius_nebulosus	A
Hynobius_tsuensis	A
Hynobius_okiensis	A
Hynobius_leechii	A
Hynobius_yangi	A
Hynobius_quelpaertensis	A
Hynobius_nigrescens	A
Hynobius_takedai	A
Hynobius_lichenatus	A
Hynobius_tokyoensis	A
Hynobius_abei	A
Hynobius_stejnegeri	A
Hynobius_arisanensis	A
Hynobius_sonani	A
Hynobius_formosanus	A
Hynobius_glacialis	A
Hynobius_fucus	A
Hynobius_boulengeri	A
Hynobius_kimurae	A
Hynobius_retardatus	A
Pseudohynobius_kuankuoshuiensis	A
Pseudohynobius_guizhouensis	A
Pseudohynobius_shuichengensis	A
Pseudohynobius_jinfo	A
Pseudohynobius_flavomaculatus	A
Pseudohynobius_puxiongensis	A
Liua_tsinpaensis	A
Liua_shihi	A
Batrachuperus_pinchonii	A
Batrachuperus_londongensis	A
Batrachuperus_tibetanus	A
Batrachuperus_karlschmidti	A
Batrachuperus_yenyuanensis	A
Salamandrella_tridactyla	A
Salamandrella_keyserlingii	A
Pachyhynobius_shangchengensis	A
Afghanodon_mustersi	A
Paradactylodon_persicus	A
Ranodon_sibiricus	A
Onychodactylus_japonicus	A
Onychodactylus_nipponoborealis	A
Onychodactylus_zhangyapingi	A
Onychodactylus_koreanus	A
Onychodactylus_fischeri	A
Onychodactylus_zhaoermii	A
Andrias_davidianus	P
Andrias_japonicus	P
Cryptobranchus_alleganiensis	P
